加入			かにゅう			その会に加入させてもらえなかった
再発			さいはつ			そういう事故は再発する恐れがあります
兎角			とかく				涙は兎角に止まなかった　（止む　個人の力では扱いかねるものに用いられるように思います。)(止まる　赤信号で止まりましたか)
>兼ねる			かねる				unable to do sth こういう事情ですから、残念ながら、せっかくのご招待をおうけいたしかねるのです
喋る			しゃべる			黙っていたことを後悔した人より、しゃべったことを後悔した人が多い。
>掌				たなごころ			おいおい当城を掌にし
取り混ぜる		とりまぜる			彼らはトマトを大小取り混ぜて売った
>従って			したがって			according to;先生の忠告に従って行動したほうがよい
>志				こころざし			何事をするにも志が大切
貫禄			かんろく			dignity 君は課長としての貫禄がない
欠席			けっせき			無断で欠席すべきではない
困難			こんなん			問題はいかにして我々がげんざいの困難を切り抜けるかである
事情			じじょう			彼女に会うべきかどうかは私自身が決める事情だ
>伺う			うかがう			call on;pay a visit;wait on;ask;hear;be told; 本日は伺うことができませんでした。
>刃				は					刃の鋭い、刃は鋭い
家計			かけい				彼女は家計のやり繰りに頭を抱えている
物資			ぶっし				公平に言って、彼は自分の限られた部下と物資で最善を尽くした
転校			てんこう			転校生は先生の鉛筆を削って機嫌を取った
手配			てはい				誰かお宅へ車で迎えに行くよう手配しておきましょうか
>呟く			つぶやく			嘀咕 叽歪 彼は学校に対する不満を呟いた　He muttered complaints against the school
>隠れる			かくれる			彼は戸の陰に隠れた
関税			かんぜい			
>博士			はかせ				
列				れつ				
作物			さくもつ			
食卓			しょくたく			
>流れ			ながれ				細水長流　なが　
多数決			たすうけつ			
審判			しんぱん			
生産			せいさん			
余分			よぶん				
>苦しい			くるしい			
>峰				みね				その峰は雲の上に聳（そび）えている
客観			きゃっかん			
>駆け足			かけあし			駆け足は速く走ること。 人間と馬などの動物に用いられる。
出来事			できごと			
				きつい				
>滑らか			すべらか			
遮光			しゃこう			武漢話　下課
特徴			とくちょう			
福祉			ふくし				
目眩			めまい				
日頃			ひごろ				
長々			ながなが			
静的			せいてき			
>肌				はだ				
>少女			おとめ				
要素			ようそ				
議論			ぎろん				
>床				とこ
				ジュース
号				ごう
原点			げんてん
出品			しゅっぴん
商人			しょうにん
				ぐっと
>杯				さかずき			
大衆			たいしゅう
正式			せいしき			
絶対			ぜったい
意思			いし
方々			ほうぼう
努力			どりょく
作曲			さっきょく
食欲			しょくよく
確実			かくじつ
圧迫			あっぱく
>歪む			ゆがむ
横切る			よこぎる
全盛			ぜんせい
>脇				わき
漢語			かんご
>宝				たから
>素				もと
戦闘			せんとう
密				みつ
誘惑			ゆうわく
和文			わぶん
日常			にちじょう
飼育			しいく
団体			だんたい
>煩わしい		わずらわしい
広告			こうこく
浮力			ふりょく
				どうにか
気配			きはい
面倒			めんどう
>現す			あらわす
迷子			まいご
>握る			にぎる
>連れ			つれ
>然し			しかし
高速			こうそく
>其処ら			そこら
後者			こうしゃ
偉大			いだい
食物			しょくもつ
収容			しゅうよう
>腹				はら
>凌ぐ			しのぐ				endure to get over 夏の暑さを凌ぐ
収穫			しゅうかく			
駐車			ちゅうしゃ			
題				だい				
配慮			はいりょ			
活発			かっぱつ
				ボーイ
式				しき				
快適			かいてき			
通行			つうこう			
>欺く			あざむく			
>凝る			こごる
>勢い			いきおい			
豊作			ほうさく
母親			ははおや
退治			たいじ
発作			ほっさ
>自惚れ			うぬぼれ
有利			ゆうり
電子			でんし
>滑らか			なめらか
詰らない		つまらない
全快			ぜんかい
丸める			まるめる
>於				お
>基づく			もとづく
>取り除く		とりのぞく
>効く			きく
死亡			しぼう
>雄				おす
主張			しゅちょう
警告			けいこく
創刊			そうかん
人工			じんこう
税務署			ぜいむしょ
独身			どくしん
>敢えて			あえて
夜中			やちゅう
頑丈			がんじょう
辛い			つらい
塩				えん
姉妹			しまい
返る			かえる
主演			しゅえん
局				きょく
>是正			ぜせい
諸君			しょくん
>炎				ほのお
改定			かいてい
知恵			ちえ
>凝らす			こごらす
可愛がる		かわいがる 
嫁				よめ
>失う			うしなう
>雪崩			なだれ
光景			こうけい
粗末			そまつ
月日			がっぴ
>球				たま
>筈				はず
>叶う			かなう
				アプローチ
解決			かいけつ
性				せい
>省く			はぶく
				パイロット
有益			ゆうえき
護衛			ごえい
其処			そこ
筋肉			きんにく
物体ない		もったいない
>担う			になう
>吊るす			つるす
永久			えいきゅう
				パイプ
銀				ぎん
>激しい			はげしい
無念			むねん
棒				ぼう
お早う			おはよう
				メディア
駐車			ちゅうしゃ
>鋭い			するどい
高				たか
象				ぞう
呉れ呉れも		くれぐれも
使用			しよう
保証			ほしょう
機嫌			きげん
生命			せいめい
老衰			ろうすい
				さん
簡素			かんそ
>お襁褓			おむつ
家出			いえで
長期			ちょうき
				アンケート
				コード
其れで			それで
				アクセル
大人しい		おとなしい
修理			しゅうり
洒落る			しゃれる
症状			しょうじょう
衛生			えいせい
喜び			よろこび
頃				ころ
技師			ぎし
要求			ようきゅう
自覚			じかく
お互い			おたがい
子息			しそく
取り替え		とりかえ
前売り			まえうり
群がる			むらがる
				タイピスト
				ストレス
				グループ
物理			ぶつり
素っ気ない		そっけない
様子			ようす
>擽ぐったい		くすぐったい
速度			そくど
約				やく
でも			でも
>平均			ならし
				ハンガー
不調			ふちょう
>源				みなもと
区				く
大事			おおごと
>空く			すく
月				つき
仕組み			しくみ
>果ない			はかない
一人			いちにん
>試す			ためす
一致			いっち
>嚏				くしゃみ
				ドラマ
地位			ちい
				とんでもない
>微か			かすか
>咎める			とがめる
>唯				ただ
砂利			じゃり
並列			へいれつ
				ケース
>叶える			かなえる
>費やす			ついやす
>伴う			ともなう
>束			たば
通信			つうしん
有力			ゆうりょく
重大			じゅうだい
禁物			きんもつ
				デモンストレーション
お祖母さん		おばあさん
				タイヤ
>乙				おつ
章				しょう
損害			そんがい
旅客			りょかく
崇拝			すうはい
食い違う		くいちがう
軽蔑			けいべつ
>携わる			たずさわる
>幼い			おさない
心臓			しんぞう
芝居			しばい
向かい			むかい
少年			しょうねん
半端			はんぱ
独自			どくじ
火燵			こたつ
清算			せいさん
記者			きしゃ
強調			きょうちょう
影響			えいきょう
慣らす			ならす
>好む			このむ
攻撃			こうげき
>怠い			だるい
嗜好			しこう
禁煙			きんえん
何				なに
祝賀			しゅくが
				ネガ
				あんなに
事実			じじつ
臭い			くさい
>富				とみ
厳密			げんみつ
外す			はずす
幕				とばり
放置			ほうち
周				しゅう
通り			とおり
				ぴったり
寄付			きふ
骨				ほね
扱う			あつかう
少々			しょうしょう
移民			いみん
関する			かんする
納得			なっとく
模範			もはん
餌				えさ
入院			にゅういん
回収			かいしゅう
整然			せいぜん
品				しな
奇数			きすう
遣り通す			やりとおす
			メモ
藍褸			ぼろ
態度			たいど
見当			けんとう
捕吏			ほり
不服			ふふく
要するに			ようするに
球			たま
仕切る			しきる
真剣			しんけん
			あくどい
老いる			おいる
基			もと
無			ぶ
工作			こうさく
植わる			うわる
潤う			うるおう
是非			ぜひ
交わる			まじわる
埋まる			うずまる
従う			したがう
処分			しょぶん
記入			きにゅう
彼此			あれこれ
句			く
交易			こうえき
雫			しずく
			グラス
有利			ゆうり
酪農			らくのう
進展			しんてん
引き受ける			ひきうける
真ん丸い			まんまるい
施す			ほどこす
判			はん
収集			しゅうしゅう
			エアメール
筋			すじ
極			ごく
居間			いま
			ビールス
感情			かんじょう
不況			ふきょう
宇宙			うちゅう
占める			しめる
下地			したじ
汽船			きせん
負担			ふたん
宗教			しゅうきょう
始まり			はじまり
式			しき
			やがて
大ざっぱ			おおざっぱ
立ち寄る			たちよる
当選			とうせん
務め			つとめ
			ラケット
			たびたび
難			なん
			わがまま
後悔			こうかい
無茶			むちゃ
手間			てま
			ヨーロッパ
中止			ちゅうし
田園			でんえん
収益			しゅうえき
所で			ところで
被害			ひがい
			ずれる
語句			ごく
			そのまま
			メッセージ
最高			さいこう
			ぺこぺこ
纏め			まとめ
			バット
役職			やくしょく
願う			ねがう
字			あざ
痛める			いためる
基本			きほん
僅か			わずか
穀物			こくもつ
進める			すすめる
語学			ごがく
巧み			たくみ
指導			しどう
傷			きず
評判			ひょうばん
大			だい
中傷			ちゅうしょう
使用人			しようにん
熱湯			ねっとう
			パスポート
			トランプ
長閑			のどか
筆			ふで
幕			まく
晴天			せいてん
拗れる			こじれる
類			たぐい
			クリスマス
			ごめんなさい
備え付ける			そなえつける
描く			かく
参考			さんこう
悩む			なやむ
天候			てんこう
名高い			なだかい
哀れ			あわれ
頼る			たよる
隠れる			かくれる
優勢			ゆうせい
飛行			ひこう
印刷			いんさつ
原則			げんそく
審判			しんぱん
脱出			だっしゅつ
受け取り			うけとり
			ゆっくり
傾向			けいこう
建設			けんせつ
済まない			すまない
富む			とむ
渡り鳥			わたりどり
辛抱			しんぼう
気に入る			きにいる
免許			めんきょ
人工			じんこう
輝く			かがやく
			どんなに
本名			ほんみょう
豆			まめ
失業			しつぎょう
其の儘			そのまま
不当			ふとう
身長			しんちょう
語る			かたる
その			その
典型			てんけい
講習			こうしゅう
下す			おろす
政権			せいけん
旗			はた
修行			しゅうぎょう
殴る			なぐる
持ち上げる			もちあげる
主婦			しゅふ
外方			そっぽ
農家			のうか
同僚			どうりょう
不平			ふへい
御			お
名付ける			なづける
第一			だいいち
			レクリエーション
頂く			いただく
為る			なる
			アラブ
文句			もんく
明確			めいかく
逃れる			のがれる
恋			こい
対話			たいわ
事情			じじょう
目付き			めつき
山岳			さんがく
決議			けつぎ
効果			こうか
ご苦労様			ごくろうさま
繋ぐ			つなぐ
その内			そのうち
日本			にっぽん
掲示			けいじ
変更			へんこう
生物			せいぶつ
			ポジション
同様			どうよう
特徴			とくちょう
支度			したく
取っ手			とって
効く			きく
怪獣			かいじゅう
松			まつ
衆			しゅう
要求			ようきゅう
無駄			むだ
言わば			いわば
			てっきり
信仰			しんこう
合致			がっち
銃			つつ
猛烈			もうれつ
鉄鋼			てっこう
産物			さんぶつ
月曜			げつよう
一敗			いっぱい
中			ちゅう
			ペア
失う			うしなう
委員			いいん
宿泊			しゅくはく
従兄弟			いとこ
試し			ためし
見解			けんかい
日光			にっこう
巨			こ
結び付き			むすびつき
燃料			ねんりょう
賛成			Uӣ[い
奪う			うばう
願い			ねがい
奴			やっこ
衣装			いしょう
責める			せめる
急速			きゅうそく
交渉			こうしょう
絶対			ぜったい
刺			とげ
統合			とうごう
精々			せいぜい
好み			このみ
援助			えんじょ
程度			ていど
無駄			むだ
出社			しゅっしゃ
採用			さいよう
呆気ない			あっけない
猿			さる
報告			ほうこく
独立			どくりつ
皇居			こうきょ
事態			じたい
			キャプテン
黙る			だまる
詰める			つめる
			バン
徐々に			じょじょに
裸			はだか
現れ			あらわれ
役			やく
			やはり
額			がく
関連			かんれん
			しいんと
九			きゅう
異見			いけん
郷里			きょうり
お手上げ			おてあげ
逃走			とうそう
所々			しょしょ
重なる			おもなる
陰			かげ
記事			きじ
撃つ			うつ
年齢			ねんれい
指図			さしず
台無し			だいなし
困難			こんなん
何時でも			いつでも
海峡			かいきょう
氏			うじ
一昨昨日			さきおととい
方			ほう
克服			こくふく
			さっぱり
契約			けいやく
提案			ていあん
意思			いし
僧			そう
日付			かづけ
特派			とくは
多分			たぶん
退職			たいしょく
慌ただしい			あわただしい
感じる			かんじる
御			ご
領域			りょういき
末			すえ
無邪気			むじゃき
			ドリル
袋			ふくろ
見せ物			みせもの
寒気			かんき
食事			しょくじ
問い			とい
画家			がか
快適			かいてき
			ですから
演技			えんぎ
			ありがとう
王様			おうさま
過去			かこ
最も			もっとも
開拓			かいたく
本能			ほんのう
癖			くせ
幸せ			しあわせ
円			まる
取り立てる			とりたてる
教習			きょうしゅう
今日			こんにち
睡眠			すいみん
定義			ていぎ
回送			かいそう
怠ける			なまける
住			じゅう
食品			しょくひん
翼			つばさ
増す			ます
塔			とう
決勝			けっしょう
首都			しゅと
日光			にっこう
正直			しょうじき
			あるいは
谷			たに
忽ち			たちまち
男の人			おとこのひと
札			さつ
制			せい
建築			けんちく
当たり前			あたりまえ
論じる			ろんじる
駆ける			かける
繋ぐ			つなぐ
手錠			てじょう
許す			ゆるす
戦災			せんさい
土曜			どよう
名誉			めいよ
勧める			すすめる
体育			たいいく
勤務			きんむ
剥がす			はがす
博物館			はくぶつかん
数える			かぞえる
脈			みゃく
頬			ほほ
器用			きよう
物質			ぶっしつ
受け入れる			うけいれる
乾			ほし
所定			しょてい
			いつか
			エンジン
			スキー
審議			しんぎ
状			じょう
祝う			いわう
満月			まんげつ
運輸			うんゆ
息			いき
素朴			そぼく
梯子			ていし
方々			かたがた
牛			うし
感度			かんど
運用			うんよう
経つ			たつ
唯一			ゆいいつ
墓			はか
勧め			すすめ
			ナプキン
			ざっと
不景気			ふけいき
			やがて
			ニュー
縁			ふち
包み			つつみ
主体			しゅたい
すると			すると
引用			いんよう
中継			ちゅうけい
直接			ちょくせつ
			とんだ
今晩は			こんばんは
手法			しゅほう
王様			おうさま
結合			けつごう
人生			じんせい
蔵			くら
支給			しきゅう
上			うわ
比較			ひかく
			わざと
目覚しい			めざましい
上空			じょうくう
寄贈			きそう
神聖			しんせい
地下			ちか
眼科			がんか
相続			そうぞく
制限			せいげん
視察			しさつ
真相			しんそう
纏まり			まとまり
咳			せき
税			ぜい
贈る			おくる
当てる			あてる
愛			あい
			ばてる
気流			きりゅう
憧れ			あこがれ
発達			はったつ
貴女			あなた
棄権			きけん
現われる			あらわれる
刊行			かんこう
止す			よす
大戦			たいせん
建設			けんせつ
ずぶ濡れ			ずぶぬれ
報道			ほうどう
宛			あて
頬っぺた			ほっぺた
街			がい
結束			けっそく
全て			すべて
慣例			かんれい
年月			ねんげつ
物置き			ものおき
			ハイキング
伜			せがれ
軽快			けいかい
一挙に			いっきょに
年生			ねんせい
一般			いっぱん
合唱			がっしょう
未婚			みこん
そう			そう
誕生			たんじょう
出版			しゅっぱん
			スラックス
貧弱			ひんじゃく
貫く			つらぬく
仕舞う			しまう
			あられ
風景			ふうけい
畳			じょう
緩やか			ゆるやか
凶作			きょうさく
国産			こくさん
面する			めんする
親善			しんぜん
出生			しゅっしょう
玉			たま
深刻			しんこく
氏			し
胃			い
違反			いはん
品			ひん
錯覚			さっかく
履く			はく
技能			ぎのう
急激			きゅうげき
印象			いんしょう
星座			せいざ
満足			まんぞく
期待			きたい
全体			ぜんたい
強気			ごうぎ
怠ける			なまける
補償			ほしょう
良好			りょうこう
少数			しょうすう
申し分			もうしぶん
何方			どちら
弁当			べんとう
進度			しんど
私物			しぶつ
永遠			えいえん
施行			しぎょう
			バー
扱い			あつかい　
近々			きんきん
指差す			ゆびさす
物価			ぶっか
勤勉			きんべん
堂々			どうどう
分析			ぶんせき
様			よう
映える			はえる
価格			かかく
救い			すくい
観光			かんこう
何しろ			なにしろ
以前			いぜん
			あちこち
物好き			ものずき
的			まと
必ずしも			かならずしも
鋭い			するどい
換える			かえる
単に			たんに
保温			ほおん
訳			やく
蜂蜜			はちみつ
円			まる
秒			びょう
十			じゅう
盛り			さかり
用件			ようけん
お巡りさん			おまわりさん
好意			こうい
異常			いじょう
欠点			けってん
回			かい
末			すえ
流し			ながし
茶の湯			ちゃのゆ
急激			きゅうげき
真面目			まじめ
比例			ひれい
要請			ようせい
			ぶかぶか
教訓			きょうくん
			よい
作			さく
診察			しんさつ
話題			わだい
防ぐ			ふせぐ
態勢			たいせい
焚火			たきび
憲法			けんぽう
配達			はいたつ
都市			とし
疑う			うたがう
或			ある
図			ず
判			ばん
度			ど
保母			ほぼ
過多			かた
主要			しゅよう
見っともない			みっともない
傑			けつ
禁煙			きんえん
良心			りょうしん
妙			みょう
下			しも
国土			こくど
敬具			けいぐ
延べ			のべ
類似			るいじ
			サイン
簡潔			かんけつ
弾			たま
助手			じょしゅ
首相			しゅしょう
貴族			きぞく
主人公			しゅじんこう
結成			けっせい
稲			いね
じゃん拳			じゃんけん
少々			しょうしょう
用紙			ようし
借金			しゃっきん
伊井			いい
			おしゃべり
涙			なみだ
単に			たんに
便			びん
寄り掛かる			よりかかる
			コンテスト
抜ける			ぬける
変革			へんかく
繕う			つくろう
高尚			こうしょう
痛み			いたみ
			と
商売			しょうばい
知識			ちしき
			まさに
			ポイント
考古学			こうこがく
迷惑			めいわく
衛星			えいせい
			なかなか
紡績			ぼうせき
楽観			らっかん
確り			しっかり
対する			たいする
公募			こうぼ
			ボーイ
抽選			ちゅうせん
殺す			ころす
基金			ききん
批判			ひはん
稼ぐ			かせぐ
			だらけ
近郊			きんこう
究極			きゅうきょく
			メロディー
差し支える			さしつかえる
教授			きょうじゅ
木曜			もくよう
休憩			きゅうけい
疲れ			つかれ
			アイデア
移動			いどう
奇妙			きみょう
治療			ちりょう
			ミリ
容易い			たやすい
貨幣			かへい
渦			うず
不			ふ
天			あまつ
思わず			おもわず
六			む
			ダイヤ
			ビール
切り			きり
公開			こうかい
支える			ささえる
舞う			まう
差額			さがく
嘆く			なげく
一瞬			いっしゅん
待ち遠しい			まちどおしい
現実			げんじつ
溺れる			おぼれる
如何に			いかに
消防			しょうぼう
電線			でんせん
			どうしても
爆弾			ばくだん
しまう			（終わる）
			コピー
出会う			であう
一まず			ひとまず
所在			しょざい
破損			はそん
煙たい			けむたい
前進			ぜんしん
対面			たいめん
絵画			かいが
追い込む			おいこむ
遭難			そうなん
止す			よす
誤差			ごさ
絡む			からむ
依存			いそん
合議			ごうぎ
値引き			ねびき
弾む			はずむ
魂			こん
自然			しぜん
			のんびり
明かす			あかす
辞める			やめる
泊			はく
生産			せいさん
滅亡			めつぼう
帰宅			きたく
取り扱い			とりあつかい
表情			ひょうじょう
気楽			きらく
木綿			きわた
錯誤			さくご
土手			どて
決意			けつい
			はさみ
全国			ぜんこく
倒す			たおす
調理			ちょうり
申し入れる			もうしいれる
郵便			ゆうびん
秘書			ひしょ
情緒			じょうしょ
額			ひたい
下取り			したどり
明後日			みょうごにち
勧誘			かんゆう
悪戯			いたずら
発車			はっしゃ
			ストロー
			ますます
演奏			えんそう
留学			りゅうがく
調査			ちょうさ
援助			えんじょ
青春			せいしゅん
見込み			みこみ
換算			かんさん
縦			たて
宣言			せんげん
愛情			あいじょう
保管			ほかん
伸ばす			のばす
両替			りょうがえ
冒険			ぼうけん
御免なさい			ごめんなさい
日本			にほん
意志			いし
弾			たま
処理			しょり
巣			す
事実			じじつ
世辞			せじ
観覧			かんらん
			いけない
何時も			いつも
根本			こんぽん
少なくとも			すくなくとも
証明			しょうめい
友情			ゆうじょう
制限			せいげん
受け取る			うけとる
案内			あんない
完成			かんせい
結晶			けっしょう
異常			いじょう
			さて
映写			えいしゃ
叩く			たたく
愛想			あいそ
便			びん
記入			きにゅう
様相			ようそう
問屋			といや
			カムバック
教職			きょうしょく
進呈			しんてい
張り紙			はりがみ
荒廃			こうはい
戸			こ
よろしく			（感）
光沢			こうたく
束			たば
互い			たがい
			レース
兎			うさぎ
馬鹿			ばか
任せる			まかせる
満足			まんぞく
加わる			くわわる
契機			けいき
瞬き			またたき
人気			にんき
入手			にゅうしゅ
中毒			ちゅうどく
売り出す			うりだす
輪			わ
為る			なる
可			か
運動			うんどう
抱く			いだく
違い			ちがい
粗末			そまつ
平均			へいきん
理解			りかい
旅			たび
余程			よっぽど
崖			がけ
努めて			つとめて
機嫌			きげん
等			とう
暫く			しばらく
益々			ますます
貰う			もらう
売り出し			うりだし
瞬間			しゅんかん
破産			はさん
目覚める			めざめる
主食			しゅしょく
誤解			ごかい
倒産			とうさん
秘密			ひみつ
感じ			かんじ
大空			おおぞら
内			うち
川			かわ
幅			はば
艶			えん
損失			そんしつ
書き取る			かきとる
年間			ねんかん
間			ま
全て			すべて
自然			しぜん
			トップ
現在			げんざい
棒			ぼう
求める			もとめる
思い付き			おもいつき
			ベース
連ねる			つらねる
			アウト
明々後日			しあさって
些事			さじ
秘密			ひみつ
組織			そしき
業績			ぎょうせき
			チーズ
検査			けんさ
穏やか			おだやか
寄与			きよ
縁談			えんだん
			ガイド
			チェンジ
代理			だいり
協定			きょうてい
屹度			きっと
曖昧			あいまい
滅茶苦茶			めちゃくちゃ
利根			りこん
貸し			かし
行動			こうどう
反感			はんかん
住民			じゅうみん
手掛かり			てがかり
預ける			あずける
この間			このあいだ
外す			はずす
			はさみ
優先			ゆうせん
領土			りょうど
超			ちょう
銃			じゅう
宜しい			よろしい
とん			（1000
衣料			いりょう
混乱			こんらん
情報			じょうほう
			ソロ
細菌			さいきん
出会い			であい
効果			こうか
歩道			ほどう
温度			おんど
至る			いたる
譲る			ゆずる
莫大			ばくだい
固体			こたい
恐怖			きょうふ
不			ふ
しまった			（感）
			おまえ
異動			いどう
			メモ
正当			せいとう
上達			じょうたつ
			トンネル
合わせる			あわせる
園			えん
厄介			やっかい
根気			こんき
導入			どうにゅう
土地			とち
自信			じしん
宝石			ほうせき
			ドライバー
寄付			きふ
ジェット機			ジェットき
所得			しょとく
二十			はたち
			ドライブ
決断			けつだん
証明			しょうめい
何			なん
夜更け			よふけ
点検			てんけん
どれ			どれ
昼飯			ちゅうはん
過ごす			すごす
昨			さく
華やか			はなやか
望み			のぞみ
			これら
特有			とくゆう
			タレント
夫人			ふじん
年月			ねんげつ
概略			がいりゃく
敵			てき
就く			つく
丸っきり			まるっきり
			ピクニック
疑惑			ぎわく
或いは			あるいは
相対			あいたい
海路			うみじ
抱える			かかえる
行政			ぎょうせい
購買			こうばい
火傷			かしょう
無事			ぶじ
			で
恰度			ちょうど
お菜			おかず
			スイッチ
父親			ちちおや
積極的			せっきょくてき
句			く
違反			いはん
有る			ある
地獄			じごく
暗記			あんき
終える			おえる
			メンバー
幼い			おさない
親戚			しんせき
獣			けだもの
運営			うんえい
回覧			かいらん
偶			たま
土産			みやげ
悪魔			あくま
			コントラスト
記念			きねん
他			た
製造			せいぞう
介護			かいご
美術			びじゅつ
動詞			どうし
誇り			ほこり
海運			かいうん
化学			かがく
会見			かいけん
他方			たほう
雰囲気			ふんいき
分			ぶん
腰			こし
注ぐ			つぐ
俳優			はいゆう
形勢			けいせい
調和			ちょうわ
計			けい
仕様			しよう
連れ			つれ
			ややこしい
状況			じょうきょう
勇敢			ゆうかん
誇る			ほこる
涸れる			かれる
悪口			わるくち
現在			げんざい
乗っ取る			のっとる
お使い			おつかい
蹴飛ばす			けとばす
措置			そち
故			こ
当て字			あてじ
食糧			しょくりょう
孫			まご
団扇			うちわ
			まごつく
非難			ひなん
家事			かじ
石油			せきゆ
			どんなに
			ぐらい
正			せい
放送			ほうそう
暦			こよみ
始発			しはつ
鍋			なべ
推薦			すいせん
縁			ふち
愚か			おろか
不安			ふあん
来る			きたる
			マスター
報酬			ほうしゅう
			サボる
			いつまでも
配給			はいきゅう
繁盛			はんじょう
原爆			げんばく
落とす			おとす
切開			せっかい
謙る			へりくだる
自殺			じさつ
観察			かんさつ
			ベストセラー
入浴			にゅうよく
取り調べる			とりしらべる
			あいにく
慎む			つつしむ
成長			せいちょう
器			うつわ
伝来			でんらい
謎			なぞ
			メンバー
保護			ほご
結局			けっきょく
洪水			こうずい
濯ぐ			すすぐ
切ない			せつない
上司			じょうし
愈々			いよいよ
礼儀			れいぎ
今にも			いまにも
仕掛ける			しかける
結核			けっかく
版			はん
			クレーン
感染			かんせん
会談			かいだん
再現			さいげん
散歩			さんぽ
準急			じゅんきゅう
正午			しょうご
仕える			つかえる
屋根			やね
強力			きょうりょく
大げさ			おおげさ
人情			にんじょう
話題			わだい
弁護			べんご
			ボート
追跡			ついせき
築く			きずく
徹夜			てつや
出血			しゅっけつ
脚色			きゃくしょく
化繊			かせん
伝統			でんとう
懐く			なつく
ふと			（副）
液			えき
脇			わき
物理			ぶつり
履歴			りれき
暗算			あんざん
張る			はる
総			そう
新築			しんちく
衣服			いふく
頑固			がんこ
顎			あご
逆らう			さからう
奥			おく
巨大			きょだい
			ユーモア
ね			（感）
一時			いちじ
根			ね
火曜			かよう
			ゆっくり
組合			くみあい
黒板			こくばん
何卒			なにとぞ
祭			まつり
如何しても			どうしても
継ぐ			つぐ
所属			しょぞく
最も			もっとも
論じる			ろんじる
炎			ほのお
受け取る			うけとる
			ずるずる
機能			きのう
福			ふく
格			かく
見事			みごと
付き			つき
今回			こんかい
束縛			そくばく
退く			しりぞく
代わる代わる			かわるがわる
退化			たいか
相談			そうだん
転居			てんきょ
罪			つみ
階級			かいきゅう
物音			ものおと
吸収			きゅうしゅう
草臥れる			くたびれる
例			れい
休戦			きゅうせん
合格			ごうかく
			デザート
密か			ひそか
二十			はたち
滞る			とどこおる
番目			ばんめ
学期			がっき
友人			ゆうじん
医療			いりょう
絶望			ぜつぼう
佐			さ
割り込む			わりこむ
尻尾			しっぽ
大便			だいべん
母校			ぼこう
苦手			にがて
膨れる			ふくれる
濠			ごう
漏れる			もれる
依頼			いらい
恵み			めぐみ
雅致			がち
出来物			できもの
奮闘			ふんとう
担架			たんか
精神			せいしん
夜中			よなか
適用			てきよう
受身			うけみ
片思い			かたおもい
突破			とっぱ
下位			かい
結果			けっか
未熟			みじゅく
気味			きみ
論文			ろんぶん
場			ば
			コントロール
			ぼつぼつ
稲光			いなびかり
文句			もんく
種			たね
順番			じゅんばん
何なり			なんなり
経つ			たつ
差			さ
苦痛			くつう
当てはまる			あてはまる
添う			そう
教科書			きょうかしょ
振興			しんこう
拡大			かくだい
			もしも
過ち			あやまち
本場			ほんば
食事			しょくじ
景気			けいき
染まる			そまる
翼			つばさ
授ける			さずける
暗殺			あんさつ
			ブーツ
			こだわる
出来るだけ			できるだけ
追い付く			おいつく
手当て			てあて
柔軟			じゅうなん
逸らす			そらす
勤め			つとめ
			トラック
読者			どくしゃ
教員			きょういん
			どんな
睡眠			すいみん
気に入る			きにいる
			おじいさん
貴重			きちょう
			そのまま
方策			ほうさく
明らか			あきらか
拡大			かくだい
信任			しんにん
演習			えんしゅう
域外			いきがい
指す			さす
最中			さいちゅう
転換			てんかん
競技			きょうぎ
皮			かわ
向き			むき
姿			すがた
著			ちゃく
切っ掛け			きっかけ
どう			（接。副）
取り締まる			とりしまる
石油			せきゆ
			すごい
灯			ともしび
			アワー
			うんざり
雌			めす
東			あずま
金曜			きんよう
			サイクル
幾ら			いくら
推理			すいり
助ける			たすける
支払う			しはらう
化する			かする
注文			ちゅうもん
不在			ふざい
最善			さいぜん
			トランジスター
音色			おんいろ
潮			うしお
天然			てんねん
麻			あさ
風呂			ふろ
舌			した
排水			はいすい
組			くみ
料			りょう
流す			ながす
			チーム
嫌う			きらう
辿る			たどる
恥じらう			はじらう
創造			そうぞう
象徴			しょうちょう
紛らわしい			まぎらわしい
申し込む			もうしこむ
迚も			とても
怒鳴る			どなる
流れる			ながれる
			もろに
			いつか
			スタイル
乳			ちち
頼る			たよる
にも拘らず			にもかかわらず
装備			そうび
余り			あんまり
農家			のうか
外観			がいかん
宇宙			うちゅう
			わがまま
生身			なまみ
金持ち			かねもち
			スプリング
労力			ろうりょく
職務			しょくむ
言伝			ことづて
禅			ぜん
出発			しゅっぱつ
不幸			ふこう
雑木			ざつぼく
迷惑			めいわく
何時か			いつか
持ち切り			もちきり
大半			たいはん
			アウト
基			もと
微妙			びみょう
貴重			きちょう
暇			いとま
運			うん
時期			じき
勘弁			かんべん
閲覧			えつらん
物議			ぶつぎ
具体			ぐたい
喜び			よろこび
明かり			あかり
寧ろ			むしろ
			それでも
飽和			ほうわ
加える			くわえる
出直し			でなおし
問い			とい
お休み			おやすみ
			ホール
寝かせる			ねかせる
無駄遣い			むだづかい
			マーケット
肩			かた
打つ			ぶつ
始末			しまつ
語彙			ごい
文字			もんじ
版画			はんが
			びっくり
梅雨			ばいう
放す			はなす
			ノック
身体			からだ
茎			くき
策			さく
細やか			こまやか
代表			だいひょう
貧しい			まずしい
煙			けむり
申告			しんこく
統制			とうせい
日			にち
回り			まわり
想像			そうぞう
			にっこり
臨む			のぞむ
不正			ふせい
前提			ぜんてい
就職			しゅうしょく
魚			うお
温暖			おんだん
都			みやこ
至る			いたる
教授			きょうじゅ
聖書			せいしょ
加味			かみ
出身			しゅっしん
綿			めん
文字			もじ
倣			ほう
			シナリオ
人類			じんるい
成人			せいじん
其れでは			それでは
破壊			はかい
役立つ			やくだつ
			すんなり
誤る			あやまる
助言			じょげん
異なる			ことなる
水気			すいき
刷り			すり
症状			しょうじょう
下番			かばん
質疑			しつぎ
重複			じゅうふく
収まる			おさまる
適宜			てきぎ
招き			まねき
首都			しゅと
端			はし
物質			ぶっしつ
優れる			すぐれる
直接			ちょくせつ
引き起こす			ひきおこす
帰宅			きたく
仏			ふつ
比較			ひかく
梅			うめ
産婦人科			さんふじんか
確かめる			たしかめる
一度に			いちどに
自身			じしん
			ポンプ
矢っ張り			やっぱり
茶			ちゃ
教科			きょうか
付ける			つける
成人			せいじん
科目			かもく
幸運			こううん
変更			へんこう
連帯			れんたい
官僚			かんりょう
治安			ちあん
澄ます			すます
次いで			ついで
個			か
富豪			ふごう
青年			せいねん
怠慢			たいまん
祭			まつり
			レディー
切れる			きれる
			パーセント
追い出す			おいだす
私有			しゆう
豊か			ゆたか
読書			どくしょ
方々			ほうぼう
反乱			はんらん
予想			よそう
信用			しんよう
危害			きがい
団体			だんたい
即座に			そくざに
歩む			あゆむ
祝う			いわう
全			ぜん
過ごす			すごす
吠える			ほえる
退屈			たいくつ
			ジーンズ
既婚			きこん
替える			かえる
空腹			くうふく
鍵			かぎ
本当			ほんとう
噂			うわさ
語学			ごがく
延期			えんき
言語			げんご
身			み
			ぐっすり
事項			じこう
心強い			こころづよい
保険			ほけん
包む			くるむ
救助			きゅうじょ
知り合い			しりあい
論文			ろんぶん
留める			とめる
向く			むく
支持			しじ
署名			しょめい
触れる			ふれる
立ち上がる			たちあがる
太陽			たいよう
捕獲			ほかく
			そして
管理			かんり
曇			くもり
台			だい
植物			しょくぶつ
牛			うし
慕う			したう
応急			おうきゅう
事前			じぜん
最高			さいこう
華奢			かしゃ
家具			かぐ
神経			しんけい
面白い			おもしろい
占領			せんりょう
			こんにちは
雷			かみなり
粘る			ねばる
立体			りったい
			ただ
従って			したがって
輸出			ゆしゅつ
割り算			わりざん
日当			にっとう
			そして
泉			いずみ
出席			しゅっせき
感じ			かんじ
垂れる			たれる
			いつでも
終			おわり
綿			わた
いつも			いつも
革			かわ
金庫			きんこ
面目			めんぼく
			ソース
			おおい
衝突			しょうとつ
いつも			いつも
充実			じゅうじつ
軍事			ぐんじ
首脳			しゅのう
其れ共			それとも
面皰			にきび
象			ぞう
放り込む			ほうりこむ
年代			ねんだい
丸ごと			まるごと
			レポート
匹			ひき
彼処			あそこ
主要			しゅよう
克服			こくふく
離婚			りこん
与える			あたえる
要点			ようてん
作用			さよう
剥げる			はげる
理想			りそう
可能			かのう
手品			てじな
			セレモニー
通り過ぎる			とおりすぎる
			ユニーク
泉			いずみ
参加			さんか
然も			さも
成る			なる
邪魔			じゃま
はあ			（感）
込める			こめる
軍			いくさ
照明			しょうめい
奇麗			きれい
始めまして			はじめまして
			トンネル
円			えん
軍備			ぐんび
悟る			さとる
木曜			もくよう
直ぐ			すぐ
断然			だんぜん
抜ける			ぬける
訓練			くんれん
			そこで
			バイオリン
磁器			じき
座席			ざせき
装置			そうち
極めて			きわめて
度			たび
予測			よそく
土			つち
錆び			さび
余裕			よゆう
行為			こうい
斜面			しゃめん
結び			むすび
			オーバー
刺激			しげき
国有			こくゆう
強調			きょうちょう
表			ひょう
			ティッシュペーパー
次			し
甘口			あまくち
冬眠			とうみん
捻子			ねじ
位置			いち
囲む			かこむ
被害			ひがい
嘘			うそ
はあ			（感）
故郷			こきょう
家来			けらい
和やか			なごやか
銀			ぎん
弁償			べんしょう
公然			こうぜん
棟			とう
			より
共			きょう
惜しむ			おしむ
豊か			ゆたか
便り			たより
又			また
			セット
統治			とうじ
			いつまでも
善			ぜん
煌々と			こうこうと
製鉄			せいてつ
闇			やみ
区画			くかく
急に			きゅうに
構う			かまう
範囲			はんい
機械			きかい
精々			せいぜい
勢い			いきおい
実際			じっさい
機関			きかん
転任			てんにん
番			ばん
年寄り			としより
抜く			ぬく
騒ぎ			さわぎ
本格			ほんかく
裁く			さばく
軒			けん
組			くみ
何			なに
始まり			はじまり
押さえる			おさえる
			きっぱり
掴む			つかむ
班			はん
大陸			たいりく
進学			しんがく
残り			のこり
失望			しつぼう
知らせ			しらせ
何の			どの
審判			しんぱん
忠実			ちゅうじつ
ご座います			ございます
禁じる			きんじる
軋む			きしむ
			マスター
条件			じょうけん
民族			みんぞく
読み			よみ
満たす			みたす
計器			けいき
数			かず
嘗める			なめる
節約			せつやく
下痢			げり
記録			きろく
九			く
化ける			ばける
分			ぶ
柄			がら
切実			せつじつ
人気			にんき
立ち上がる			たちあがる
尉			じょう
流行			はやり
強める			つよめる
採決			さいけつ
			あした
着飾る			きかざる
有する			ゆうする
注文			ちゅうもん
申し訳			もうしわけ
職員			しょくいん
仰っしゃる			おっしゃる
味方			みかた
諦める			あきらめる
武器			ぶき
			カテゴリー
幹線			かんせん
野生			やせい
弱める			よわめる
価値			かち
土産			みやげ
酔う			よう
拝啓			はいけい
夕べ			ゆうべ
軒			のき
			ロケット
間もなく			まもなく
要するに			ようするに
文			ぶん
共通			きょうつう
都市			とし
商品			しょうひん
点火			てんか
			なお
老い			おい
向け			むけ
助			じょ
同僚			どうりょう
扶養			ふよう
気風			きふう
神			かみ
未だ			まだ
避ける			さける
返済			へんさい
人物			じんぶつ
節			ふし
職			しょく
偶			たま
好ましい			このましい
帯			おび
発行			はっこう
差し引く			さしひく
胸			むね
苦痛			くつう
書斎			しょさい
遠方			えんぽう
調印			ちょういん
標語			ひょうご
活ける			いける
			タオル
哲学			てつがく
司法			しほう
一度に			いちどに
主任			しゅにん
教材			きょうざい
庁			ちょう
沿岸			えんがん
盛り上がる			もりあがる
貰う			もらう
浴びる			あびる
前			せん
改悪			かいあく
明くる			あくる
売れる			うれる
販売			はんばい
漂う			ただよう
全滅			ぜんめつ
納まる			おさまる
微笑む			ほほえむ
			スター
集中			しゅうちゅう
訳			やく
何時			いつ
就職			しゅうしょく
我慢			がまん
潜入			せんにゅう
遊牧			ゆうぼく
国家			こっか
位			くらい
違いない			ちがいない
単一			たんいつ
花びら			はなびら
自立			じりつ
質			しつ
金属			きんぞく
抓る			つねる
取り組む			とりくむ
姓名			せいめい
下さる			くださる
月賦			げっぷ
構える			かまえる
展望			てんぼう
			しきりに
			たとえ
越す			こす
骨折			こっせつ
終える			おえる
			センス
煙草			たばこ
破産			はさん
量			りょう
一帯			いったい
			ちらっと
月曜			げつよう
書斎			しょさい
			ダンプ
移行			いこう
事			こと
機能			きのう
創立			そうりつ
			ショー
			ドライ
			スープ
案じる			あんじる
考慮			こうりょ
			びっしょり
			ヒント
瞑る			つぶる
説く			とく
児			こ
権力			けんりょく
天然			てんねん
無効			むこう
諄い			くどい
原書			げんしょ
詩人			しじん
少女			しょうじょ
塾			じゅく
約			やく
動詞			どうし
繁殖			はんしょく
傍ら			かたわら
別に			べつに
僅か			わずか
脱退			だったい
			それぞれ
日曜			にちよう
乗せる			のせる
鼠			ねずみ
煙る			けむる
議決			ぎけつ
泳ぎ			およぎ
見舞い			みまい
生温い			なまぬるい
笑い			わらい
下り			くだり
行儀			ぎょうぎ
明らか			あきらか
態度			たいど
緊急			きんきゅう
			レバー
励む			はげむ
何処か			どこか
溝			こう
			かわいらしい
植民地			しょくみんち
			ニュアンス
金			かね
必然			ひつぜん
著名			ちょめい
撃つ			うつ
及ぼす			およぼす
			セット
下す			おろす
二人			ににん
旧			きゅう
理屈			りくつ
明瞭			めいりょう
本館			ほんかん
付属			ふぞく
眺め			ながめ
感謝			かんしゃ
命中			めいちゅう
発芽			はつが
敗戦			はいせん
だから			だから
経営			けいえい
同時			どうじ
戸籍			こせき
真下			ました
記憶			きおく
蓋			がい
傾向			けいこう
公			おおやけ
悲劇			ひげき
物足りない			ものたりない
指揮			しき
何で			なんで
資格			しかく
時刻			じこく
			ジャンプ
品			ひん
横断			おうだん
且つ			かつ
専ら			もっぱら
首輪			くびわ
			どんな
信頼			しんらい
書物			しょもつ
無難			ぶなん
博士			はかせ
分配			ぶんぱい
取材			しゅざい
年齢			ねんれい
適応			てきおう
設備			せつび
傾く			かたぶく
開始			かいし
購読			こうどく
藁			わら
軒			のき
雷			いかずち
週間			しゅうかん
間柄			あいだがら
			ピン
土台			どだい
優秀			ゆうしゅう
泳ぎ			およぎ
お昼			おひる
表す			あらわす
抗争			こうそう
混同			こんどう
体力			たいりょく
等級			とうきゅう
述べる			のべる
			ペンキ
後退			こうたい
思想			しそう
出世			しゅっせ
禁止			きんし
化粧			けしょう
議案			ぎあん
実			じつ
仕上げ			しあげ
精神			せいしん
生まれ			うまれ
沈む			しずむ
迅速			じんそく
導く			みちびく
養成			ようせい
			で
酷い			ひどい
世の中			よのなか
等しい			ひとしい
無知			むち
			おまえ
器官			きかん
傾			けい
気の毒			きのどく
無論			むろん
この頃			このごろ
強盗			ごうとう
出版			しゅっぱん
指導			しどう
横切る			よこぎる
お産			おさん
器用			きよう
責任			せきにん
大した			たいした
脅す			おどす
替える			かえる
頂く			いただく
最低			さいてい
天体			てんたい
驚異			きょうい
何となく			なんとなく
葦			よし
素晴らしい			すばらしい
波			なみ
基本			きほん
			ポーズ
感無量			かんむりょう
			よると
半ば			なかば
漏る			もる
給料			きゅうりょう
原作			げんさく
			さっと
夢中			むちゅう
区切り			くぎり
			クラブ
年間			ねんかん
文明			ぶんめい
現像			げんぞう
逆らう			さからう
ノー			（no）
理解			りかい
見当			けんとう
加える			くわえる
分母			ぶんぼ
			ですから
下心			したごころ
発			はつ
短縮			たんしゅく
側面			そくめん
丸い			まるい
手術			しゅじゅつ
承知			しょうち
婚約			こんやく
見る			みる
華美			かび
連休			れんきゅう
意志			いし
数字			すうじ
殺す			ころす
問い合わせる			といあわせる
無料			むりょう
屈折			くっせつ
独占			どくせん
巣			す
返還			へんかん
底			そこ
世紀			せいき
屋敷			やしき
記者			きしゃ
勤め先			つとめさき
支払う			しはらう
働き			はたらき
実に			じつに
掲げる			かかげる
費用			ひよう
運動			うんどう
黴菌			ばいきん
真心			まこころ
不可			ふか
勇気			ゆうき
決まり			きまり
躊躇う			ためらう
いえ			いえ
青年			せいねん
明白			あからさま
手回し			てまわし
飼う			かう
大方			おおかた
合わせる			あわせる
明るい			あかるい
碁盤			ごばん
頂上			ちょうじょう
社			やしろ
効き目			ききめ
総合			そうごう
			まさに
兼用			けんよう
大部分			だいぶぶん
七日			なぬか
武力			ぶりょく
代			しろ
願う			ねがう
質素			しっそ
所為			せい
内乱			ないらん
分ける			わける
接ぐ			つぐ
部			ぶ
			デコレーション
越える			こえる
			ストライキ
自主			じしゅ
			がっかり
感慨			かんがい
地域			ちいき
年鑑			ねんかん
傾斜			けいしゃ
			トーン
雇う			やとう
組む			くむ
繁栄			はんえい
金融			きんゆう
はい			（感）
故障			こしょう
吸収			きゅうしゅう
配偶者			はいぐうしゃ
訪問			ほうもん
掃除			そうじ
天才			てんさい
辺り			あたり
手段			しゅだん
襲撃			しゅうげき
体付き			からだつき
鼠			ねず
調子			ちょうし
嫌う			きらう
停留所			ていりゅうじょ
お腹			おなか
後			ご
高価			こうか
			インフレ
都会			とかい
検討			けんとう
補強			ほきょう
腿			もも
局			きょく
価値			かち
			マイク
台			だい
道徳			どうとく
悲しむ			かなしむ
			よい
完璧			かんぺき
互い			たがい
陸			りく
供給			きょうきゅう
金			きん
桐			きり
面倒			めんどう
今日は			こんにちは
当時			とうじ
際			きわ
歌手			かしゅ
採掘			さいくつ
勉強			べんきょう
悪化			あっか
手分け			てわけ
霜			しも
人体			じんたい
操る			あやつる
表情			ひょうじょう
平均			へいきん
強いて			しいて
収穫			しゅうかく
郷愁			きょうしゅう
省く			はぶく
見舞			みまい
			プラン
謝絶			しゃぜつ
			スープ
驚き			おどろき
多忙			たぼう
流れ			ながれ
冗談			じょうだん
物語			ものがたり
可愛い			かわいい
記事			きじ
登山			とざん
くっ付く			くっつく
栄える			さかえる
念			ねん
切れ			きれ
吃逆			しゃっくり
給料			きゅうりょう
一家			いっか
当てる			あてる
途端			とたん
反抗			はんこう
寛容			かんよう
茹でる			ゆでる
悪口			あっこう
昇る			のぼる
抵抗			ていこう
小包			こづつみ
株			かぶ
躓く			つまずく
居る			おる
背景			はいけい
一体			いったい
飲み込む			のみこむ
注目			ちゅうもく
御手洗い			おてあらい
岸			きし
沿う			そう
			ごめんなさい
消息			しょうそく
			まさか
籠			かご
認識			にんしき
価格			かかく
題			だい
率直			そっちょく
填める			はめる
缶			かん
昇進			しょうしん
流行			りゅうこう
			ケース
隠す			かくす
何故なら			なぜなら
重要			じゅうよう
生まれつき			うまれつき
七			なな
予感			よかん
越える			こえる
採集			さいしゅう
健康			けんこう
学問			がくもん
			ダブる
目的			もくてき
働き			はたらき
礼儀			れいぎ
病			やまい
人格			じんかく
冷淡			れいたん
眺める			ながめる
伝説			でんせつ
関心			かんしん
汚らわしい			けがらわしい
法案			ほうあん
交える			まじえる
			ストロボ
弱る			よわる
眼球			がんきゅう
情け深い			なさけぶかい
据え付ける			すえつける
慣習			かんしゅう
			ルール
了承			りょうしょう
			ほぼ
匂い			におい
日			にち
仲人			ちゅうにん
内容			ないよう
副			とりわけ
責める			せめる
推測			すいそく
其れから			それから
騙す			だます
梅雨			ばいう
握る			にぎる
怪我			けが
髪の毛			かみのけ
実情			じつじょう
酸化			さんか
出合う			であう
公演			こうえん
規模			きぼ
			ガレージ
応じる			おうじる
見せびらかす			みせびらかす
味わい			あじわい
			てんで
為来り			しきたり
飽きる			あきる
対			たい
河川			かせん
支度			したく
中枢			ちゅうすう
健やか			すこやか
攻撃			こうげき
種々			くさぐさ
告げる			つげる
抱える			かかえる
恩			おん
境遇			きょうぐう
見積り			みつもり
月謝			げっしゃ
取り戻す			とりもどす
浜			はま
売れ行き			うれゆき
生死			せいし
夫婦			ふうふ
初版			しょはん
			こんなに
引退			いんたい
学習			がくしゅう
明確			めいかく
悪い			にくい
想像			そうぞう
			しゃべる
放送			ほうそう
甲			きのえ
新鮮			しんせん
			うがい
踵			かかと
名人			めいじん
盛り			さかり
目盛			めもり
交付			こうふ
不明			ふめい
万一			まんいち
巧妙			こうみょう
期待			きたい
脆い			もろい
罰			ばち
正直			しょうじき
模様			もよう
経る			へる
			モニター
受け入れ			うけいれ
			レギュラー
我がまま			わがまま
原子			げんし
脳			のう
底			そこ
不満			ふまん
軒並み			のきなみ
間々			まま
止むを得ない			やむをえない
			いらいら
返答			へんとう
はい			（感）
存在			そんざい
害する			がいする
			ずれ
練習			れんしゅう
消耗			しょうこう
特産			とくさん
必死			ひっし
当てはめる			あてはめる
侮辱			ぶじょく
無視			むし
大戦			たいせん
			あんまり
争い			あらそい
選挙			せんきょ
控室			ひかえしつ
招く			まねく
減る			へる
父親			ちちおや
風土			ふうど
制裁			せいさい
膨脹			ぼうちょう
			とにかく
役			やく
跡切れる			とぎれる
突っ張る			つっぱる
出鱈目			でたらめ
七			なな
遅れ			おくれ
肉体			にくたい
梢			こずえ
当たる			あたる
組織			そしき
			あべこべ
行動			こうどう
現場			げんじょう
疲労			ひろう
運命			うんめい
制約			せいやく
支出			ししゅつ
数字			すうじ
一目			いちもく
花粉			かふん
著書			ちょしょ
着席			ちゃくせき
強いる			しいる
			すてき
素晴らしい			すばらしい
苛々			いらいら
だから			だから
誠			まこと
叩く			たたく
卯			ぼう
何			なん
優れる			すぐれる
一気			いっき
外			ほか
土地			とち
直			じき
銅			あかがね
縦			たて
実施			じっし
王			おう
蝶			ちょう
			ぐっすり
異性			いせい
不振			ふしん
金			かね
種			しゅ
			パス
専攻			せんこう
緊張			きんちょう
区別			くべつ
比重			ひじゅう
移動			いどう
全			ぜん
相当			そうとう
未来			みらい
諮る			はかる
細胞			さいぼう
			おどおど
建前			たてまえ
眼鏡			がんきょう
			オレンジ
厄介			やっかい
			がっちり
馬			うま
医師			いし
老い			おい
同調			どうちょう
作品			さくひん
没落			ぼつらく
宿泊			しゅくはく
攻め			せめ
籠			かご
脅かす			おどかす
渋滞			じゅうたい
骨			こつ
用品			ようひん
裏返し			うらがえし
見苦しい			みぐるしい
改良			かいりょう
			しばしば
世間			せけん
此れ			これ
日中			にっちゅう
等しい			ひとしい
どうぞ宜しく			どうぞよろしく
予報			よほう
邸宅			ていたく
罪			つみ
			デモ
在庫			ざいこ
勧める			すすめる
休暇			きゅうか
機			はた
減点			げんてん
湾			わん
名札			なふだ
仕立てる			したてる
氷			こおり
復興			ふっこう
調停			ちょうてい
完成			かんせい
召す			めす
親戚			しんせき
心理			しんり
尚更			なおさら
そこ			そこ
否定			ひてい
手元			てもと
篭る			こもる
支給			しきゅう
			すばしこい
職業			しょくぎょう
計る			はかる
限界			げんかい
列			れつ
解ける			とける
元来			がんらい
同居			どうきょ
清潔			せいけつ
個性			こせい
生			き
余り			あまり
上			うわ
工場			こうば
尻			しり
肩			かた
道徳			どうとく
正義			せいぎ
			ドライブイン
我々			われわれ
急に			きゅうに
上京			じょうきょう
銃			じゅう
完了			かんりょう
光景			こうけい
模索			もさく
体温			たいおん
件			くだん
痛む			いたむ
天災			てんさい
軸			じく
			がっくり
危ぶむ			あやぶむ
殆ど			ほとんど
汗			あせ
代弁			だいべん
逞しい			たくましい
正常			せいじょう
訴える			うったえる
向上			こうじょう
取り締まり			とりしまり
皿			さら
覆す			くつがえす
畑			はたけ
傲る			おごる
権限			けんげん
任命			にんめい
投票			とうひょう
所が			ところが
直感			ちょっかん
構え			かまえ
全く			まったく
捜査			そうさ
票			ひょう
景気			けいき
お大事に			おだいじに
各			おのおの
刑罰			けいばつ
演奏			えんそう
鬼			おに
上陸			じょうりく
意外			いがい
於いて			おいて
倹約			けんやく
平常			へいじょう
不思議			ふしぎ
下火			したび
救う			すくう
農民			のうみん
大概			たいがい
冠			かん
環境			かんきょう
誇り			ほこり
昼間			ちゅうかん
地域			ちいき
劇場			げきじょう
一番			いちばん
暮れ			くれ
衛星			えいせい
減少			げんしょう
今更			いまさら
通			つう
食料			しょくりょう
語る			かたる
人			じん
借り			かり
			スピード
事			こと
角			かく
街			まち
制する			せいする
然うして			そうして
			ゼリー
不安			ふあん
遅らす			おくらす
意図			いと
組み合わせ			くみあわせ
次々			つぎつぎ
部下			ぶか
清々しい			すがすがしい
追う			おう
添える			そえる
罵る			ののしる
側			そば
前置き			まえおき
貸し			かし
素早い			すばやい
			ゲスト
値			ね
眺める			ながめる
準備			じゅんび
告白			こくはく
理性			りせい
粗			あら
会			かい
経営			けいえい
直ちに			ただちに
漠然			ばくぜん
不思議			ふしぎ
練る			ねる
偶然			ぐうぜん
出身			しゅっしん
光熱費			こうねつひ
麻酔			ますい
熱量			ねつりょう
設立			せつりつ
的			てき
成り立つ			なりたつ
身			み
取れる			とれる
値段			ねだん
趣旨			しゅし
			ダンス
引っ張る			ひっぱる
給仕			きゅうじ
適度			てきど
混乱			こんらん
練習			れんしゅう
現象			げんしょう
党			とう
ローマ字			ローマじ
宙返り			ちゅうがえり
若しかすると			もしかすると
満ちる			みちる
略奪			りゃくだつ
物事			ものごと
及ぶ			およぶ
			どこか
			コメント
津波			つなみ
降伏			こうふく
生物			せいぶつ
案の定			あんのじょう
給う			たまう
無断			むだん
協調			きょうちょう
丸			まる
乗客			じょうきゃく
両替			りょうがえ
匂い			におい
兆			きざし
飼う			かう
方向			ほうこう
嫁			よめ
厭やらしい			いやらしい
泥			どろ
太陽			たいよう
隔週			かくしゅう
戻す			もどす
鉄棒			かなぼう
作業			さぎょう
女子			じょし
会			かい
			ビデオ
住宅			じゅうたく
断る			ことわる
			ボール
経験			けいけん
正しく			まさしく
気兼ね			きがね
適切			てきせつ
対立			たいりつ
拵える			こしらえる
列車			れっしゃ
幾つ			いくつ
乗客			じょうきゃく
耕作			こうさく
感動			かんどう
予測			よそく
損			そん
殺人			さつじん
欠く			かく
小切手			こぎって
行き違い			いきちがい
			それと
訴え			うったえ
拍手			はくしゅ
			クイズ
学歴			がくれき
船			ふね
安静			あんせい
構成			こうせい
			グラフ
家主			いえぬし
善し悪し			よしあし
自己			じこ
協会			きょうかい
以来			いらい
食卓			しょくたく
			アルバム
突く			つつく
可			か
地主			じぬし
			スポーツカー
			ざっと
世紀			せいき
専攻			せんこう
船			ふね
規範			きはん
逆立ち			さかだち
突然			とつぜん
制服			せいふく
武器			ぶき
頭痛			ずつう
郵便			ゆうびん
			ソファー
進学			しんがく
図書			としょ
貢献			こうけん
如何			いかが
診察			しんさつ
			グループ
出入り口			でいりぐち
繊維			せんい
箇所			かしょ
尿			にょう
			すごい
隠す			かくす
日常			にちじょう
裂ける			さける
			スタイル
随分			ずいぶん
無礼			ぶれい
流行			りゅうこう
位			くらい
栄養			えいよう
溢れる			あふれる
連想			れんそう
酒			さけ
沢山			たくさん
			ママ
仲			なか
風俗			ふうぞく
館			たち
綻びる			ほころびる
			キロ
			いざ
できる			（可能。出現。発生）
物事			ものごと
合計			ごうけい
打撃			だげき
許す			ゆるす
仕上がり			しあがり
			パイプ
関与			かんよ
			ガイドブック
一層			いっそう
茶の間			ちゃのま
宝器			ほうき
柵			さく
剃る			する
甘い			うまい
膝			ひざ
距離			きょり
			あと
世話			せわ
誇張			こちょう
			けれど
合意			ごうい
乃至			ないし
調子			ちょうし
円			えん
参考			さんこう
ここ			ここ
提携			ていけい
食物			しょくもつ
恐らく			おそらく
傷付く			きずつく
造り			つくり
望む			のぞむ
相場			そうば
様々			さまざま
主導			しゅどう
			キャッチ
			ドラマ
褒める			ほめる
国交			こっこう
支店			してん
輪			りん
短波			たんぱ
呼吸			こきゅう
			テント
転転			てんてん
一息			ひといき
対比			たいひ
			プロ
次第			しだい
			ヨーロッパ
			グランド
雑貨			ざっか
雨天			うてん
短気			たんき
諸			しょ
最終			さいしゅう
国会			こっかい
小屋			こや
あざ笑う			あざわらう
余所見			よそみ
腐敗			ふはい
裏切る			うらぎる
辞職			じしょく
伝言			つてごと
			しぶとい
譲る			ゆずる
館			かん
未			ひつじ
対して			たいして
			エンジン
派			は
悪日			あくび
暮らし			くらし
値			あたい
兎も角			ともかく
刑事			けいじ
規約			きやく
個人			こじん
誤魔化す			ごまかす
乱す			みだす
嫉妬			しっと
立場			たちば
動員			どういん
協議			きょうぎ
今回			こんかい
円滑			えんかつ
刀			かたな
此れ等			これら
			およそ
分ける			わける
			ちゃんと
物音			ものおと
感謝			かんしゃ
掬う			すくう
表面			ひょうめん
発車			はっしゃ
斑			ぶち
歓迎			かんげい
進出			しんしゅつ
冷静			れいせい
実態			じったい
直ちに			ただちに
及び			および
伺う			うかがう
海流			かいりゅう
限る			かぎる
達成			たっせい
背負う			しょう
公平			こうへい
企業			きぎょう
割る			わる
投入			とうにゅう
法			ほう
張る			はる
行員			こういん
主に			おもに
			ところで
一般			いっぱん
脅迫			きょうはく
当人			とうにん
女優			じょゆう
現金			げんきん
現実			げんじつ
責任			せきにん
仰ぐ			あおぐ
経緯			いきさつ
足し算			たしざん
親友			しんゆう
丘			おか
逆転			ぎゃくてん
一筋			ひとすき
税金			ぜいきん
桜			さくら
障害			しょうがい
苦労			くろう
期			き
強行			きょうこう
嵐			あらし
癖			くせ
正			せい
強制			きょうせい
金銭			きんせん
填まる			はまる
地球			ちきゅう
叫ぶ			さけぶ
			おっかない
知識			ちしき
忠告			ちゅうこく
分			ふん
血管			けっかん
雑			ざつ
一種			いっしゅ
実行			じっこう
			ボルト
繰り返す			くりかえす
椅子			いす
遂げる			とげる
突如			とつじょ
一様			いちよう
微量			びりょう
心配			しんぱい
九			く
中学			ちゅうがく
発生			はっせい
文明			ぶんめい
好み			このみ
息			いき
公認			こうにん
征服			せいふく
本の			ほんの
穴			あな
少女			しょうじょ
収入			しゅうにゅう
心地			ここち
反り			そり
健康			けんこう
維持			いじ
評価			ひょうか
送金			そうきん
台本			だいほん
白状			はくじょう
小			しょう
暮らす			くらす
貢献			こうけん
高まる			たかまる
基			もとい
中古			ちゅうこ
歌手			かしゅ
縮まる			ちぢまる
			デート
			グレー
俺			おれ
普段			ふだん
徹底			てってい
廃棄			はいき
一家			いっか
準じる			じゅんじる
柄			え
挑む			いどむ
口頭			こうとう
仕掛け			しかけ
無			む
答案			とうあん
新た			あらた
軽率			けいそつ
政策			せいさく
嘗て			かつて
地形			じぎょう
何か			なにか
装飾			そうしょく
聞き取り			ききとり
最終			さいしゅう
突然			とつぜん
特集			とくしゅう
選手			せんしゅ
週			しゅう
			サンキュー
代金			だいきん
真珠			しんじゅ
出発			しゅっぱつ
燃える			もえる
敵			てき
状態			じょうたい
冒頭			ぼうとう
虫歯			むしば
祈り			いのり
死			し
義務			ぎむ
海外			かいがい
嗚呼			ああ
ここ			ここ
悲劇			ひげき
見事			みごと
奇妙			きみょう
集中			しゅうちゅう
業			ごう
宛てる			あてる
役場			やくば
農業			のうぎょう
			ポット
影響			えいきょう
評価			ひょうか
			ロープ
存続			そんぞく
似合う			にあう
従業員			じゅうぎょういん
財産			ざいさん
後回し			あとまわし
定期			ていき
何とか			なんとか
本質			ほんしつ
典型			てんけい
物語			ものがたり
日付			ひづけ
気候			きこう
何時の間にか			いつのまにか
鼠			ねずみ
密度			みつど
類推			るいすい
当たる			あたる
上等			じょうとう
以て			もって
吟味			ぎんみ
差異			さい
工学			こうがく
赤ちゃん			あかちゃん
面			おも
			ゲーム
入院			にゅういん
			こんにちは
飛び出す			とびだす
陽気			ようき
真理			しんり
単位			たんい
			あと
作戦			さくせん
暴動			ぼうどう
手段			しゅだん
教え			おしえ
霧			きり
学			がく
行き			いき
天皇			すめらぎ
			ジュース
海抜			かいばつ
引っ掛ける			ひっかける
			マッサージ
気障			きざ
契約			けいやく
大胆			だいたん
西日			にしび
傾ける			かたむける
十			とお
覚悟			かくご
ぶら下げる			ぶらさげる
越す			こす
分散			ぶんさん
数える			かぞえる
玉			たま
用いる			もちいる
氷			こおり
数			すう
予算			よさん
遥か			はるか
勿論			もちろん
戦力			せんりょく
幅			はば
国語			こくご
出席			しゅっせき
食う			くう
演説			えんぜつ
稲			いね
煌びやか			きらびやか
直面			ちょくめん
丁目			ちょうめ
好評			こうひょう
頼み			たのみ
巻			まき
喧嘩			けんか
逮捕			たいほ
楽			らく
機構			きこう
戦い			たたかい
友			とも
			ドレス
展示			てんじ
通過			つうか
喜劇			きげき
管			かん
世論			せろん
早める			はやめる
彼方			あちら
			しきりに
何卒			どうぞ
種類			しゅるい
人種			じんしゅ
矢鱈に			やたらに
存在			そんざい
豪華			ごうか
推進			すいしん
日々			ひび
炙る			あぶる
沈む			しずむ
網			あみ
感動			かんどう
材料			ざいりょう
些とも			ちっとも
余裕			よゆう
一定			いちじょう
活動			かつどう
券			けん
骨折			こっせつ
反抗			はんこう
値打ち			ねうち
抱く			いだく
思考			しこう
健在			けんざい
癌			がん
製法			せいほう
宝石			ほうせき
			クリスマス
曲がる			まがる
戴きます			いただきます
共通			きょうつう
			がっしり
装置			そうち
旦那			だんな
お出でになる			おいでになる
必死			ひっし
限定			げんてい
断面			だんめん
掛け			かけ
とん			（1000
訂正			ていせい
名			な
印			しるし
甚だ			はなはだ
畏まりました			かしこまりました
慎重			しんちょう
予防			よぼう
			おそらく
其れ程			それほど
宅			たく
海外			かいがい
			スター
			ブレーキ
彼の			あの
料金			りょうきん
			いらいら
勤労			きんろう
			ライター
要望			ようぼう
役割			やくわり
素			もと
行き			ゆき
神			かみ
几帳面			きちょうめん
定食			ていしょく
含嗽			うがい
成功			せいこう
後者			こうしゃ
沈殿			ちんでん
爆破			ばくは
悪魔			あくま
解く			とく
不意			ふい
激しい			はげしい
供給			きょうきゅう
愚痴			ぐち
軍隊			ぐんたい
需要			じゅよう
勤まる			つとまる
灯			ひ
両立			りょうりつ
兎			うさぎ
主催			しゅさい
作法			さほう
有りのまま			ありのまま
			スタンド
司る			つかさどる
王子			おうじ
僕			しもべ
			ドライクリーニング
下品			かひん
後			のち
例			ためし
劇団			げきだん
誤解			ごかい
隠居			いんきょ
採択			さいたく
注			ちゅう
課外			かがい
			ゲーム
化石			かせき
小麦			こむぎ
天国			てんごく
堪える			こらえる
間違い			まちがい
吃驚			びっくり
赤らむ			あからむ
許可			きょか
分離			ぶんり
外交			がいこう
語			ご
振動			しんどう
			データ
芝生			しばふ
余暇			よか
惑星			わくせい
賃金			ちんぎん
考え			かんがえ
仏像			ぶつぞう
何より			なにより
轢く			ひく
周期			しゅうき
			シート
暖かい			あたたか(い)
田			た
会計			かいけい
溜まり			たまり
印象			いんしょう
現代			げんだい
利子			りし
			でかい
勿論			もちろん
苗			なえ
打つ			ぶつ
嬉しい			うれしい
覆う			おおう
振り出し			ふりだし
一言			いちげん
三			み
下らない			くだらない
方法			ほうほう
残金			ざんきん
起源			きげん
電源			でんげん
通信			つうしん
離す			はなす
務め			つとめ
観			かん
下吏			かり
求める			もとめる
			ミルク
手際			てぎわ
廃れる			すたれる
裁判			さいばん
落ち着き			おちつき
割合に			わりあいに
			あちこち
微笑む			ほほえむ
支出			ししゅつ
			コーチ
重宝			じゅうほう
相応しい			ふさわしい
嘘			うそ
行き			ゆき
外交			がいこう
資本			しほん
独立			どくりつ
城			しろ
重			え
栽培			さいばい
入場			にゅうじょう
一部			いちぶ
加工			かこう
宅			たく
歎			たん
土産			どさん
家賃			やちん
引っ張る			ひっぱる
			ハイキング
位置			いち
掻き回す			かきまわす
意地			いじ
反			たん
埋め込む			うめこむ
歩道			ほどう
経過			けいか
尽きる			つきる
			エネルギー
同盟			どうめい
威力			いりょく
害			がい
如何して			どうして
坊ちゃん			ぼっちゃん
離す			はなす
甘える			あまえる
付き合い			つきあい
滅多に			めったに
対決			たいけつ
渋い			しぶい
同時			どうじ
改善			かいぜん
叫び			さけび
一括			いっかつ
定まる			さだまる
品種			ひんしゅ
対			たい
日中			にっちゅう
同封			どうふう
国境			こっきょう
非行			ひこう
詰める			つめる
食品			しょくひん
慌てる			あわてる
生			せい
髪の毛			かみのけ
軍服			ぐんぷく
温度			おんど
復活			ふっかつ
では			では
南			なん
説得			せっとく
釣			つり
朗読			ろうどく
用心			ようじん
何も			なにも
大家			おおや
所謂			いわゆる
親しい			したしい
使い道			つかいみち
観光			かんこう
募る			つのる
宜しい			よろしい
灯			ひ
現代			げんだい
回			かい
逆			ぎゃく
			フィルター
愛情			あいじょう
窮乏			きゅうぼう
欠乏			けつぼう
遅刻			ちこく
歩			ふ
			ブザー
対処			たいしょ
			じっと
助ける			たすける
演ずる			えんずる
単純			たんじゅん
恐れる			おそれる
果たして			はたして
お供			おとも
梅干			うめぼし
			パス
願い			ねがい
支える			ささえる
割			かつ
転じる			てんじる
耐える			たえる
補充			ほじゅう
沈黙			ちんもく
注目			ちゅうもく
喫茶			きっさ
改修			かいしゅう
融資			ゆうし
宝			たから
渋滞			じゅうたい
言論			げんろん
演説			えんぜつ
段			だん
			デモ
陳列			ちんれつ
望み			のぞみ
湾			わん
欠点			けってん
粉末			ふんまつ
魚			うお
入る			いる
止まる			とどまる
柄			がら
滅ぼす			ほろぼす
医師			いし
百科事典			ひゃっかじてん
			あるいは
夕べ			ゆうべ
精密			せいみつ
昨			さく
付き合う			つきあう
			レッスン
			さっぱり
腰			こし
			すなわち
際			さい
禁ずる			きんずる
其れに			それに
紐			ひも
出産			しゅっさん
			スピーチ
			ビール
外出			がいしゅつ
地方			ちほう
正解			せいかい
握手			あくしゅ
人込み			ひとごみ
世帯			せたい
赴任			ふにん
上演			じょうえん
檻			おり
過ぎ			すぎ
亜科			あか
型			かた
記録			きろく
鼾			いびき
恐れ入る			おそれいる
回路			かいろ
缶			かん
憤慨			ふんがい
冒険			ぼうけん
			よると
気品			きひん
催す			もよおす
加留多			かるた
吐く			はく
冷蔵			れいぞう
普遍			ふへん
換える			かえる
程			ほど
強力			きょうりょく
不満			ふまん
為る			する
不			ぶ
農業			のうぎょう
			ゴール
度			ど
分			ぶん
情			じょう
幕			まく
下			げ
分担			ぶんたん
			システム
何時までも			いつまでも
生き物			いきもの
恐怖			きょうふ
単なる			たんなる
作り			つくり
態々			わざわざ
同級			どうきゅう
竿			さお
			ダンス
ねじ回し			ねじまわし
愛する			あいする
			なにも
絶滅			ぜつめつ
弛み			たるみ
墓			はか
臆病			おくびょう
誤り			あやまり
表現			ひょうげん
しまい			（終わり）
水田			すいでん
			とんでもない
街道			かいどう
構う			かまう
重んじる			おもんじる
待ち望む			まちのぞむ
大臣			だいじん
現状			げんじょう
航海			こうかい
起伏			きふく
生じる			しょうじる
			レポート
途中			つちゅう
逃亡			とうぼう
予め			あらかじめ
旗			はた
			タイトル
会			え
人生			じんせい
恐れる			おそれる
実行			じっこう
菓子			かし
似合う			にあう
			カクテル
賑わう			にぎわう
友			とも
消費			しょうひ
株			かぶ
壇			だん
長官			ちょうかん
袖			そで
例え			たとえ
最中			さいちゅう
安定			あんてい
答え			こたえ
平和			へいわ
振り			ふり
予報			よほう
実際			じっさい
単			ひとえ
			なぜなら
発見			はっけん
溶液			ようえき
恥			はじ
概念			がいねん
何でも			なんでも
豆			まめ
代わる			かわる
可愛らしい			かわいらしい
開始			かいし
退屈			たいくつ
			ますます
漁村			ぎょそん
酸っぱい			すっぱい
打ち合わせる			うちあわせる
双子			ふたご
			しくじる
刑			けい
猿			さる
ご馳走さま			ごちそうさま
怯える			おびえる
再建			さいけん
組み込む			くみこむ
境			さかい
合間			あいま
後			のち
奪う			うばう
真似			まね
辞退			じたい
製			せい
			そっと
久し振り			ひさしぶり
誤り			あやまり
固める			かためる
			ブレーキ
配分			はいぶん
旧知			きゅうち
提出			ていしゅつ
			マーク
記念			きねん
根拠			こんきょ
促進			そくしん
初耳			はつみみ
胴			どう
確保			かくほ
運送			うんそう
転勤			てんきん
恋愛			れんあい
等			など
見すぼらしい			みすぼらしい
材料			ざいりょう
悩ましい			なやましい
奨励			しょうれい
認める			みとめる
議題			ぎだい
			デッサン
順			じゅん
硬い			かたい
貶す			けなす
仏			ほとけ
何と			なんと
ジェット機			ジェットき
為さる			なさる
時刻表			じこくひょう
記載			きさい
秩序			ちつじょ
この			この
無口			むくち
操作			そうさ
週間			しゅうかん
嵩む			かさむ
何れ			いずれ
貧困			ひんこん
役割			やくわり
間			ま
歯磨			はみがき
整理			せいり
特権			とっけん
出来事			できごと
民宿			みんしゅく
徹夜			てつや
変動			へんどう
一方			いっぽう
会員			かいいん
残高			ざんだか
			びり
依頼			いらい
			ジーンズ
自動			じどう
一変			いっぺん
外貨			がいか
皺			しわ
軍			ぐん
決定			けってい
喋る			しゃべる
			タイム
打ち消し			うちけし
重視			じゅうし
穴			あな
迫害			はくがい
治まる			おさまる
濃い			こい
差別			さべつ
罰する			ばっする
			アンコール
			ノック
生き物			いきもの
			たまらない
凡そ			およそ
同い年			おないどし
侍			さむらい
久しい			ひさしい
頬			ほお
織			おり
捕まる			つかまる
整理			せいり
弾く			はじく
			バッグ
			それと
			あんなに
双子			ふたご
交わす			かわす
流通			りゅうつう
筋			すじ
沖			おき
丈			だけ
誘う			さそう
犯罪			はんざい
釣鐘			つりがね
関連			かんれん
心臓			しんぞう
長			おさ
別れ			わかれ
手掛ける			てがける
字体			じたい
成長			せいちょう
契る			ちぎる
初			はつ
弱			じゃく
説			せつ
居住			きょじゅう
地下			ちか
予防			よぼう
一見			いちげん
課題			かだい
無意味			むいみ
死刑			しけい
立派			りっぱ
流れる			ながれる
図書			としょ
産後			さんご
ふと			（副）
皮			かわ
油			あぶら
不足			ふそく
都会			とかい
当時			とうじ
近代			きんだい
偶に			たまに
就業			しゅうぎょう
何でも			なんでも
恥じる			はじる
収める			おさめる
貯蓄			ちょちく
敏感			びんかん
老ける			ふける
殿			しんがり
熱中			ねっちゅう
偽造			ぎぞう
服装			ふくそう
鋸			のこぎり
精巧			せいこう
逮捕			たいほ
一切			いっさい
余興			よきょう
滑稽			こっけい
手軽			てがる
幽霊			ゆうれい
庶民			しょみん
虎			とら
実			み
描写			びょうしゃ
始め			はじめ
弓			ゆみ
無し			なし
土曜			どよう
助詞			じょし
布			ぬの
私			あたし
			やはり
			スキー
覚悟			かくご
阻む			はばむ
投票			とうひょう
付録			ふろく
絵画			かいが
利点			りてん
札			さつ
謎			なぞ
平等			びょうどう
武装			ぶそう
聴覚			ちょうかく
壷			つぼ
徐行			じょこう
動揺			どうよう
吹奏			すいそう
何だか			なんだか
軈て			やがて
汚染			おせん
年寄			としより
			きちんと
気候			きこう
余分			よぶん
落ち葉			おちば
段々			だんだん
頂			いただき
清らか			きよらか
			カルテ
持てる			もてる
照合			しょうごう
緩める			ゆるめる
有る			ある
諺			ことわざ
封			ふう
個々			ここ
内臓			ないぞう
討議			とうぎ
稍			やや
運転			うんてん
			きっかり
正確			せいかく
			タイプライター
受け継ぐ			うけつぐ
実は			じつは
			どうやら
			うるさい
着			ちゃく
側			かわ
一瞬			いっしゅん
日曜			にちよう
資産			しさん
			ジャンパー
			たった
産出			さんしゅつ
養護			ようご
上達			じょうたつ
蓄積			ちくせき
参議院			さんぎいん
学習			がくしゅう
辿り着く			たどりつく
解く			ほどく
救う			すくう
兵器			へいき
気質			かたぎ
			いただきます
結び付く			むすびつく
過疎			かそ
拘束			こうそく
預ける			あずける
			パジャマ
言う			ゆう
上			じょう
尊敬			そんけい
与える			あたえる
乗り込む			のりこむ
節			ふし
封建			ほうけん
			コンタクト
症			しょう
御覧なさい			ごらんなさい
部分			ぶぶん
中央			ちゅうおう
不自由			ふじゆう
守備			しゅび
数詞			すうし
幾つ			いくつ
正規			せいき
対抗			たいこう
他			た
燃える			もえる
上下			うえした
変遷			へんせん
世話			せわ
講読			こうどく
			かわいらしい
飯			めし
四			よん
生			なま
速度			そくど
付き合い			つきあい
心掛ける			こころがける
教科書			きょうかしょ
輸入			ゆにゅう
応じる			おうじる
共存			きょうそん
小児科			しょうにか
鞠			まり
引き分け			ひきわけ
完全			かんぜん
出くわす			でくわす
入場			にゅうじょう
果て			はて
堤防			ていぼう
例			れい
寄こす			よこす
予期			よき
震える			ふるえる
動き			うごき
書き取り			かきとり
動向			どうこう
			ヨット
実践			じっせん
味方			みかた
裾			すそ
決まり			きまり
飽きる			あきる
尊重			そんちょう
異なる			ことなる
出演			しゅつえん
起こす			おこす
目録			もくろく
演技			えんぎ
腹			はら
選手			せんしゅ
品質			ひんしつ
利益			りえき
			かわいそう
山腹			さんぷく
板			いた
世間			せけん
議員			ぎいん
			じゃあ
済ませる			すませる
熱心			ねっしん
疾っくに			とっくに
天候			てんこう
布巾			ふきん
杖			つえ
微塵			みじん
楽しむ			たのしむ
下			しも
期間			きかん
染める			そめる
山脈			さんみゃく
昆虫			こんちゅう
			のんびり
帰京			ききょう
取り分			とりわけ
区々			まちまち
丘陵			きゅうりょう
放射能			ほうしゃのう
飛ばす			とばす
志望			しぼう
生じる			しょうじる
笛			ふえ
環境			かんきょう
畑			はたけ
訓			くん
吐く			はく
加減			かげん
順調			じゅんちょう
			オープン
規制			きせい
			ロケット
油絵			あぶらえ
差し掛かる			さしかかる
縁側			えんがわ
上がる			あがる
増す			ます
膳			ぜん
似通う			にかよう
好況			こうきょう
風呂			ふろ
野			の
真剣			しんけん
跡			あと
お目出度う			おめでとう
			そこで
納入			のうにゅう
手芸			しゅげい
			コーチ
意気込む			いきごむ
玉			ぎょく
連中			れんじゅう
真似			まね
手伝い			てつだい
厳か			おごそか
お目に掛かる			おめにかかる
上回る			うわまわる
見逃す			みのがす
大した			たいした
一面			いちめん
伸びる			のびる
着陸			ちゃくりく
年頃			としごろ
況して			まして
金曜			きんよう
善良			ぜんりょう
水準			すいじゅん
表す			あらわす
融通			ゆうずう
割引き			わりびき
国境			くにざかい
野外			やがい
描く			かく
遠慮			えんりょ
実験			じっけん
発育			はついく
			うがい
保存			ほぞん
来場			らいじょう
			チャイム
戸締り			とじまり
鉄片			てっぺん
登山			とざん
知事			ちじ
早急			さっきゅう
			サイズ
捕らえる			とらえる
様式			ようしき
営業			えいぎょう
地平線			ちへいせん
一生			いっしょう
判定			はんてい
注			ちゅう
圧力			あつりょく
見通し			みとおし
訪問			ほうもん
父母			ちちはは
元			もと
盾			たて
出切る			できる
大抵			たいてい
国家			こっか
			なんだかんだ
仮令			たとえ
即ち			すなわち
権威			けんい
相手			あいて
遂に			ついに
祝い			いわい
陶器			とうき
圏			けん
申し出る			もうしでる
然して			そして
			いつでも
終始			しゅうし
気温			きおん
逃げ出す			にげだす
経験			けいけん
上京			じょうきょう
陸			りく
語			ご
多様			たよう
汚れる			けがれる
保存			ほぞん
大気			たいき
中			ちゅう
確かめる			たしかめる
軒			けん
慣行			かんこう
			ウイスキー
適切			てきせつ
			じっくり
新人			しんじん
待望			たいぼう
異議			いぎ
内部			ないぶ
結果			けっか
			ホーム
夜			よ
擦る			かする
自首			じしゅ
売れる			うれる
守る			まもる
備える			そなえる
少しも			すこしも
負う			おう
追及			ついきゅう
			ルーズ
未だ			いまだ
天井			てんじょう
極			ごく
言う			ゆう
丸で			まるで
無料			むりょう
時期			じき
移住			いじゅう
月			つき
利益			りえき
打ち込む			うちこむ
完了			かんりょう
			つまり
計画			けいかく
急かす			せかす
			そのうち
直に			じかに
身体			しんたい
優美			ゆうび
十			じゅう
			マイク
感覚			かんかく
滅多に			めったに
吠える			ほえる
苦手			にがて
末期			まっき
自ずから			おのずから
			ワイン
椅子			いす
口述			こうじゅつ
穏やか			おだやか
需要			じゅよう
単なる			たんなる
炭素			たんそ
論理			ろんり
先だって			せんだって
塵取り			ちりとり
通学			つうがく
解ける			とける
眠たい			ねむたい
冷酷			れいこく
微笑			びしょう
人類			じんるい
普段			ふだん
侵略			しんりゃく
欠ける			かける
温和			おんわ
羽			はね
不可			ふか
曲			きょく
享受			きょうじゅ
外来			がいらい
残す			のこす
布			ぬの
滞在			たいざい
賢明			けんめい
どう			（接。副）
円満			えんまん
頂上			ちょうじょう
御			お
強烈			きょうれつ
常識			じょうしき
だが			だが
被る			かぶる
借金			しゃっきん
寧ろ			むしろ
玩具			おもちゃ
手遅れ			ておくれ
目標			もくひょう
長編			ちょうへん
前途			ぜんと
作法			さほう
どれ			どれ
達する			たっする
黒板			こくばん
論争			ろんそう
			ミセス
揺らぐ			ゆらぐ
仮			か
違い			ちがい
方々			かたがた
			ショック
岸			きし
嵩張る			かさばる
未知			みち
古			いにしえ
衝突			しょうとつ
遺跡			いせき
嬢			じょう
要点			ようてん
裸			はだか
獲得			かくとく
良識			りょうしき
恩			おん
避ける			さける
修学			しゅうがく
農場			のうじょう
緊張			きんちょう
直			じき
泡			あわ
煽てる			おだてる
			ラベル
区間			くかん
			タイマー
古代			こだい
迎え			むかえ
必修			ひっしゅう
男の人			おとこのひと
漏らす			もらす
経費			けいひ
防衛			ぼうえい
見渡す			みわたす
主婦			しゅふ
案内			あんない
劣る			おとる
事態			じたい
雰囲気			ふんいき
酸			さん
遠慮			えんりょ
可哀想			かわいそう
本気			ほんき
万人			ばんじん
知事			ちじ
新			しん
道場			どうじょう
防火			ぼうか
憲法			けんぽう
守衛			しゅえい
度			たび
有能			ゆうのう
拒絶			きょぜつ
滅びる			ほろびる
交互			こうご
維持			いじ
共働き			ともばたらき
釣			つり
首相			しゅしょう
蕾			つぼみ
印鑑			いんかん
盛る			さかる
豊富			ほうふ
負債			ふさい
病む			やむ
決算			けっさん
運賃			うんちん
交換			こうかん
残り			のこり
管			くだ
望む			のぞむ
俄か			にわか
その上			そのうえ
高原			こうげん
州			しゅう
			クラシック
模倣			もほう
場面			ばめん
生やす			はやす
有効			ゆうこう
園			その
染みる			しみる
三味線			さみせん
志向			しこう
公団			こうだん
設定			せってい
絶える			たえる
詳しい			くわしい
			キャンプ
雨具			あまぐ
幹			かん
販売			はんばい
得る			える
喧しい			やかましい
叫ぶ			さけぶ
			どうか
偶々			たまたま
競技			きょうぎ
煙			けむり
他意			たい
			いたずら
			つまり
何とか			なんとか
			キロ
出来るだけ			できるだけ
商売			しょうばい
擦れる			すれる
			きつい
姿			すがた
残す			のこす
消防			しょうぼう
条件			じょうけん
今後			こんご
			いい
筒			つつ
賛成			Uӣ[い
開催			かいさい
和らげる			やわらげる
伸びる			のびる
内訳			うちわけ
顧みる			かえりみる
其れ			それ
主義			しゅぎ
			コマーシャル
			いたずら
訴訟			そしょう
失望			しつぼう
			キャプテン
設備			せつび
諦め			あきらめ
任せる			まかせる
荒っぽい			あらっぽい
毛布			もうふ
尊敬			そんけい
			フロント
浴びる			あびる
中和			ちゅうわ
唯			たった
			セクション
云々			うんぬん
考え			かんがえ
襟			えり
			メーカー
一致			いっち
修正			しゅうせい
本物			ほんもの
与党			よとう
零す			こぼす
尊重			そんちょう
施設			しせつ
自慢			じまん
			がる
映像			えいぞう
香り			かおり
生まれ			うまれ
呆れる			あきれる
抜け出す			ぬけだす
しまった			（感）
密			みつ
骨董品			こっとうひん
			オーバー
再			さい
体裁			ていさい
先に			さきに
立場			たちば
行進			こうしん
姉妹			しまい
夕暮れ			ゆうぐれ
向かい			むかい
咄嗟			とっさ
年寄			としより
能			のう
見解			けんかい
成績			せいせき
不評			ふひょう
			おめでとう
影			かげ
悲鳴			ひめい
苦しむ			くるしむ
上手			うわて
政府			せいふ
厭々			いやいや
率			りつ
興じる			きょうじる
詳しい			くわしい
文語			ぶんご
震わせる			ふるわせる
道路			どうろ
収める			おさめる
接触			せっしょく
手品			てじな
			しょっちゅう
質			しつ
真っ赤			まっか
反響			はんきょう
救助			きゅうじょ
知恵			ちえ
考慮			こうりょ
			ライス
作曲			さっきょく
名称			めいしょう
綴じる			とじる
			ただ
盛装			せいそう
知的			ちてき
訪れる			おとずれる
量			りょう
両極			りょうきょく
聳える			そびえる
伐			ばつ
庶務			しょむ
記す			しるす
骨			ほね
仕舞			しまい
感触			かんしょく
読み上げる			よみあげる
矢			や
			なぜなら
彼方此方			あちらこちら
見る			みる
回り			まわり
お願いします			おねがいします
砂漠			さばく
即する			そくする
紳士			しんし
意外			いがい
種類			しゅるい
蜜			みつ
上がり			あがり
隔たる			へだたる
興業			こうぎょう
呼び止める			よびとめる
焦る			あせる
奉る			たてまつる
教師			きょうし
得る			うる
見地			けんち
夥しい			おびただしい
膝			ひざ
最早			もはや
立方			たちかた
魅力			みりょく
体温			たいおん
暗示			あんじ
痒い			かゆい
劇場			げきじょう
麻痺			まひ
合図			あいず
現す			あらわす
			こんなに
全然			ぜんぜん
罰する			ばっする
美味しい			おいしい
年月			としつき
確定			かくてい
住民			じゅうみん
稼ぐ			かせぐ
家畜			かちく
優勝			ゆうしょう
収支			しゅうし
顔付き			かおつき
内容			ないよう
理想			りそう
激励			げきれい
			センター
負傷			ふしょう
選考			せんこう
注ぐ			そそぐ
開発			かいはつ
軽減			けいげん
賄う			まかなう
碑			いしぶみ
文			ふみ
頃			ころ
			サービス
嘴			くちばし
			まるで
批判			ひはん
鉱山			こうざん
主に			おもに
描く			えがく
依然			いぜん
相当			そうとう
討論			とうろん
美人			びじん
沿線			えんせん
床			ゆか
勤め			つとめ
文書			ぶんしょ
判断			はんだん
証人			しょうにん
			ファイル
恐ろしい			おそろしい
担当			たんとう
歓声			かんせい
勘定			かんじょう
根			ね
同			どう
面			めん
休める			やすめる
座談会			ざだんかい
			カー
期間			きかん
			し
一言			ひとこと
ノー			（no）
独特			どくとく
			きちんと
現場			げんば
			えい
床			ゆか
			とにかく
暴露			ばくろ
本当			ほんとう
思い出			おもいで
医療			いりょう
			にっこり
集計			しゅうけい
知らせ			しらせ
緩む			ゆるむ
招く			まねく
馴れ馴れしい			なれなれしい
遠回り			とおまわり
深める			ふかめる
降ろす			おろす
市場			いちば
噛み切る			かみきる
			なかなか
性格			せいかく
芸術			げいじゅつ
			いずれ
切れ			きれ
助手			じょしゅ
免れる			まぬかれる
塵			ごみ
根底			こんてい
側			そば
城下			じょうか
勘			かん
勇気			ゆうき
恵む			めぐむ
御負け			おまけ
			オフィス
得意			とくい
気付く			きづく
育つ			そだつ
階			かい
反射			はんしゃ
			ビデオ
到着			とうちゃく
後			うしろ
輸出			ゆしゅつ
収入			しゅうにゅう
店			てん
冊			さつ
目蓋			まぶた
赤字			あかじ
当て			あて
様々			さまざま
思わず			おもわず
企画			きかく
感情			かんじょう
適用			てきよう
お腹			おなか
支払			しはらい
英字			えいじ
進み			すすみ
燃焼			ねんしょう
押し込む			おしこむ
画			かく
潜水			せんすい
代理			だいり
救援			きゅうえん
連邦			れんぽう
倍率			ばいりつ
物体			ぶったい
舞台			ぶたい
支店			してん
訴える			うったえる
紐			ひも
延いては			ひいては
			オリエンテーション
共学			きょうがく
連なる			つらなる
領海			りょうかい
経歴			けいれき
			ライター
印刷			いんさつ
犠牲			ぎせい
蛋白質			たんぱくしつ
若し			もし
憎しみ			にくしみ
年長			ねんちょう
混血			こんけつ
涙			なみだ
続き			つづき
遂に			ついに
お蔭			おかげ
分子			ぶんし
帯			おび
訓			くん
孤児			こじ
夜更かし			よふかし
冴える			さえる
取り寄せる			とりよせる
及ぼす			およぼす
霞む			かすむ
地位			ちい
萎びる			しなびる
濃い			こい
			さて
行き成り			いきなり
掛かる			かかる
発達			はったつ
浮気			うわき
料金			りょうきん
座席			ざせき
証拠			しょうこ
野心			やしん
物価			ぶっか
			ファイト
同一			どういつ
欲深い			よくふかい
抑制			よくせい
友情			ゆうじょう
補足			ほそく
実業家			じつぎょうか
次々			つぎつぎ
尚			なお
干渉			かんしょう
貧しい			まずしい
法学			ほうがく
出費			しゅっぴ
活用			かつよう
試す			ためす
			たまらない
			しかも
密接			みっせつ
会合			かいごう
身振り			みぶり
馬			うま
和風			わふう
計画			けいかく
すみません			（感）
			だぶだぶ
洋風			ようふう
覚ます			さます
伝達			でんたつ
取り上げる			とりあげる
補給			ほきゅう
軍艦			ぐんかん
喧嘩			けんか
見晴らし			みはらし
下り			くだり
爆発			ばくはつ
火災			かさい
大臣			だいじん
戻す			もどす
			なんか
書類			しょるい
方向			ほうこう
匹敵			ひってき
愉快			ゆかい
中腹			ちゅうっぱら
近頃			ちかごろ
偏			へん
不足			ふそく
僅			きん
進める			すすめる
国防			こくぼう
申出			もうしで
到底			とうてい
群集			ぐんしゅう
熱意			ねつい
講演			こうえん
言い訳			いいわけ
節約			せつやく
語源			ごげん
連続			れんぞく
赴く			おもむく
焦げ茶			こげちゃ
化粧			けしょう
命令			めいれい
生計			せいけい
駄目			だめ
勝る			まさる
			あらゆる
後			ご
多分			たぶん
受かる			うかる
降水			こうすい
絨毯			じゅうたん
愉快			ゆかい
名			な
事務			じむ
音			おん
親しい			したしい
親友			しんゆう
			チームワーク
財産			ざいさん
土俵			どひょう
伝統			でんとう
駄目			だめ
除く			のぞく
重要			じゅうよう
不利			ふり
飯			めし
表現			ひょうげん
懸賞			けんしょう
共産			きょうさん
壮大			そうだい
近頃			ちかごろ
内陸			ないりく
集まる			あつまる
神殿			しんでん
襲う			おそう
微妙			びみょう
			グランド
			いく
贅沢			ぜいたく
自身			じしん
事によると			ことによると
異論			いろん
詫び			わび
十			とお
では			では
不			ぶ
事柄			ことがら
概説			がいせつ
投資			とうし
新興			しんこう
議長			ぎちょう
盗み			ぬすみ
利息			りそく
盛大			せいだい
悩む			なやむ
過労			かろう
輸入			ゆにゅう
論議			ろんぎ
			そっくり
個別			こべつ
			まさか
放り出す			ほうりだす
街頭			がいとう
立派			りっぱ
成年			せいねん
押し寄せる			おしよせる
地区			ちく
近付く			ちかづく
重役			おもやく
嘘つき			うそつき
取り巻く			とりまく
職業			しょくぎょう
一頃			ひところ
不吉			ふきつ
応募			おうぼ
才能			さいのう
如何にも			いかにも
			ママ
道路			どうろ
学問			がくもん
有望			ゆうぼう
			カー
岩			いわ
実施			じっし
犯人			はんにん
本人			ほんにん
登録			とうろく
是非とも			ぜひとも
証言			しょうげん
仕上げる			しあげる
了			りょう
省みる			かえりみる
哲学			てつがく
大統領			だいとうりょう
然しながら			しかしながら
散蒔く			ばらまく
瓶			かめ
			ホース
余地			よち
単語			たんご
業務			ぎょうむ
浜辺			はまべ
解除			かいじょ
時			とき
揃い			そろい
灰			あく
直に			じかに
示す			しめす
勢力			せいりょく
			あらゆる
他			ほか
権			けん
王子			おうじ
			いち
原典			げんてん
偶々			たまたま
共稼ぎ			ともかせぎ
途端			とたん
夜中			よなか
到達			とうたつ
岩石			がんせき
上等			じょうとう
健全			けんぜん
風車			かざぐるま
肝心			かんじん
霜			しも
			げっそり
服装			ふくそう
碌な			ろくな
胃			い
植物			しょくぶつ
社宅			しゃたく
炒める			いためる
地元			じもと
捻じれる			ねじれる
原形			げんけい
外相			がいしょう
			エネルギー
決定			けってい
紛争			ふんそう
旧事			くじ
解剖			かいぼう
丈夫			じょうふ
擦れ違い			すれちがい
交際			こうさい
仕付ける			しつける
没収			ぼっしゅう
行い			おこない
若しくは			もしくは
学者			がくしゃ
閉鎖			へいさ
能			のう
校			こう
同一			どういつ
鬼			おに
増強			ぞうきょう
大気			たいき
個人			こじん
空き			あき
瓶			びん
汚す			けがす
無事			ぶじ
管理			かんり
値する			あたいする
今にも			いまにも
近代			きんだい
訓練			くんれん
冗談			じょうだん
間違い			まちがい
有様			ありさま
狂う			くるう
閉じる			とじる
自殺			じさつ
小銭			こぜに
易い			やすい
生真面目			きまじめ
左右			さゆう
莫大			ばくだい
限る			かぎる
			ぼやける
員			いん
大抵			たいてい
設計			せっけい
欠陥			けっかん
改善			かいぜん
下			げ
一言			ひとこと
現れる			あらわれる
節			せつ
背			せい
騒音			そうおん
述べる			のべる
妥協			だきょう
向く			むく
反撃			はんげき
会計			かいけい
			いずれ
先天的			せんてんてき
餌			えさ
改まる			あらたまる
男子			だんし
			そっくり
小麦			こむぎ
通常			つうじょう
若しかして			もしかして
思想			しそう
端			はし
			ジーパン
一概に			いちがいに
十分			じっぷん
人込み			ひとごみ
期末			きまつ
真っ直ぐ			まっすぐ
家賃			やちん
室			しつ
			じっと
専修			せんしゅう
時刻			じこく
成るべく			なるべく
未練			みれん
手筈			てはず
信じる			しんじる
四			し
法			ほう
対象			たいしょう
			ブーム
水準			すいじゅん
衣服			いふく
金			きん
			プロ
			セックス
誰か			だれか
学芸			がくげい
同意			どうい
不良			ふりょう
欠ける			かける
極端			きょくたん
浅ましい			あさましい
限界			げんかい
片言			かたこと
構成			こうせい
全員			ぜんいん
才能			さいのう
すると			すると
切れ目			きれめ
済ます			すます
破る			やぶる
動力			どうりょく
縄			なわ
真に			まことに
勝ち			かち
協力			きょうりょく
			フォーム
態と			わざと
持ち上げる			もちあげる
満場			まんじょう
随分			ずいぶん
一々			いちいち
学ぶ			まなぶ
修了			しゅうりょう
			いわゆる
明後日			あさって
			カーペット
藻掻く			もがく
発行			はっこう
舞台			ぶたい
雇う			やとう
作業			さぎょう
悪者			わるもの
腫れる			はれる
診療			しんりょう
万			ばん
同等			どうとう
頬			ほお
いい加減			いいかげん
高速			こうそく
容易			ようい
元年			がんねん
香り			かおり
前者			ぜんしゃ
興奮			こうふん
畜生			ちくしょう
難い			かたい
読書			どくしょ
針			はり
国連			こくれん
戦			いくさ
任務			にんむ
化合			かごう
正確			せいかく
			ハンサム
風習			ふうしゅう
含む			ふくむ
大使			たいし
居る			おる
先日			せんじつ
			アイロン
穂			ほ
しまう			（終わる）
			どうしても
促す			うながす
情け			なさけ
象			しょう
農地			のうち
経路			けいろ
性			せい
同士			どうし
			けち
再会			さいかい
毛布			もうふ
実			み
報じる			ほうじる
苦しめる			くるしめる
革新			かくしん
囲む			かこむ
恋する			こいする
進路			しんろ
月並み			つきなみ
悩ます			なやます
提示			ていじ
支配			しはい
生地			きじ
回復			かいふく
気立て			きだて
したがって			したがって
お邪魔します			おじゃまします
諺			ことわざ
土木			どぼく
評判			ひょうばん
真実			さな
滞納			たいのう
自尊心			じそんしん
			いただきます
観衆			かんしゅう
その外			そのほか
若しも			もしも
根回し			ねまわし
通り			とおり
本文			ほんぶん
保障			ほしょう
無茶苦茶			むちゃくちゃ
心理			しんり
			スタジオ
仙			せん
臍			へそ
以来			いらい
哀れ			あわれ
其れでも			それでも
生地			きじ
男子			だんし
			やや
計算			けいさん
集団			しゅうだん
唯一			ゆいいつ
設ける			もうける
金額			きんがく
控える			ひかえる
絶滅			ぜつめつ
折衷			せっちゅう
			たとえ
丘			おか
中央			ちゅうおう
動かす			うごかす
			ちゃんと
図			ず
中止			ちゅうし
図々しい			ずうずうしい
何々			どれどれ
妬む			ねたむ
独裁			どくさい
塀			へい
田			た
順調			じゅんちょう
別れ			わかれ
秒			びょう
財政			ざいせい
他人			たにん
			コミュニケーション
弛む			たるむ
欲望			よくぼう
衰える			おとろえる
堪える			たえる
協力			きょうりょく
監督			かんとく
休暇			きゅうか
捕虜			ほりょ
連盟			れんめい
幸い			さいわい
働			どう
発見			はっけん
交際			こうさい
石炭			せきたん
無言			むごん
論争			ろんそう
負け			まけ
小売			こうり
			ところが
真上			まうえ
十字路			じゅうじろ
瞬間			しゅんかん
配置			はいち
境			さかい
君主			くんしゅ
痛切			つうせつ
先代			せんだい
余り			あまり
知能			ちのう
体育			たいいく
前進			ぜんしん
要素			ようそ
楽			らく
関する			かんする
大柄			おおがら
助動詞			じょどうし
努力			どりょく
脂肪			しぼう
楽譜			がくふ
中断			ちゅうだん
化学			かがく
様			さま
塵			ごみ
			インテリ
給食			きゅうしょく
動かす			うごかす
平ら			たいら
修理			しゅうり
地平線			ちへいせん
体			てい
本人			ほんにん
観点			かんてん
人種			じんしゅ
			ところで
主観			しゅかん
刀			かたな
			おめでとう
摘む			つまむ
受け付ける			うけつける
有能			ゆうのう
従来			じゅうらい
気付く			きづく
乗せる			のせる
悪口			わるくち
平行			へいこう
時			とき
片付け			かたづけ
否定			ひてい
黙る			だまる
			トラック
適度			てきど
失業			しつぎょう
			インク
踏まえる			ふまえる
分野			ぶんや
苦労			くろう
恋人			こいびと
増し			まし
勘			かん
			カメラマン
引退			いんたい
味覚			みかく
手近			てぢか
博物館			はくぶつかん
近眼			きんがん
写し			うつし
停留所			ていりゅうじょ
口ずさむ			くちずさむ
平ら			たいら
建築			けんちく
酸素			さんそ
			アマチュア
会合			かいごう
方式			ほうしき
			バッグ
			ばったり
積もる			つもる
妙			みょう
大家			おおや
曇			くもり
法廷			ほうてい
編			へん
全員			ぜんいん
演出			えんしゅつ
状態			じょうたい
差し出す			さしだす
賠償			ばいしょう
いえ			いえ
種			たね
罹る			かかる
作物			さくぶつ
惨め			みじめ
目論見			もくろみ
香辛料			こうしんりょう
感心			かんしん
能力			のうりょく
平方			へいほう
一日			いちじつ
生臭い			なまぐさい
			ジャズ
勘定			かんじょう
うん			（感）
			ぼんやり
大いに			おおいに
側			がわ
風景			ふうけい
誠実			せいじつ
座標			ざひょう
			バン
集まり			あつまり
夜具			やぐ
首飾り			くびかざり
			スケート
			おや
			センター
体格			たいかく
優位			ゆうい
引っ掻く			ひっかく
お蔭様で			おかげさまで
くっ付ける			くっつける
能力			のうりょく
			ソックス
発言			はつげん
年中			ねんじゅう
歓迎			かんげい
通す			とおす
			そっと
神経			しんけい
修士			しゅうし
故郷			こきょう
格好			かっこう
新た			あらた
			カード
			ブルー
			タイプライター
温暖			おんだん
持続			じぞく
縁			えん
制度			せいど
眩しい			まぶしい
奥			おく
更に			さらに
哉			や
何て			なんて
牧師			ぼくし
和			わ
			ベスト
清純			せいじゅん
他動詞			たどうし
油			あぶら
折り返す			おりかえす
先日			せんじつ
悲惨			ひさん
舌			した
良い			いい
俳優			はいゆう
筆			ふで
心細い			こころぼそい
馬鹿らしい			ばからしい
課			か
辛うじて			かろうじて
落ち込む			おちこむ
女子			おなご
友人			ゆうじん
露骨			ろこつ
検事			けんじ
入賞			にゅうしょう
退学			たいがく
			パトカー
疎か			おろそか
埃			ほこり
移す			うつす
虫歯			むしば
板			いた
振る			ふる
			いち
保守			ほしゅ
被る			かぶる
議長			ぎちょう
肺			はい
蔵相			ぞうしょう
就く			つく
団結			だんけつ
現われ			あらわれ
昇る			のぼる
大統領			だいとうりょう
敬意			けいい
通じる			つうじる
			ぼやく
空			から
公立			こうりつ
金銭			きんせん
変化			へんか
或る			ある
			ジャンル
信じる			しんじる
			スペース
位地			いち
批評			ひひょう
其方			そちら
券			けん
現状			げんじょう
夜明け			よあけ
排除			はいじょ
徴収			ちょうしゅう
積もり			つもり
点線			てんせん
転回			てんかい
自我			じが
固定			こてい
依って			よって
科目			かもく
絶版			ぜっぱん
申し込み			もうしこみ
唸る			うなる
刑事			けいじ
永遠			えいえん
			バイオリン
不自由			ふじゆう
			それでも
探検			たんけん
役			えき
仲間			なかま
小			しょう
真っ二つ			まっぷたつ
若干			じゃっかん
対応			たいおう
老人			ろうじん
免除			めんじょ
愛でたい			めでたい
現れ			あらわれ
			レントゲン
感覚			かんかく
修正			しゅうせい
			アップ
到着			とうちゃく
科			か
大陸			たいりく
持ち			もち
			ダウン
礼			れい
特技			とくぎ
			あら
唾			つば
			ラケット
大			だい
留学			りゅうがく
報ずる			ほうずる
印			しるし
短歌			たんか
公平			こうへい
			ジャンボ
閉じる			とじる
梅雨			つゆ
処理			しょり
労働			ろうどう
不味い			まずい
平たい			ひらたい
衣類			いるい
運			うん
覆う			おおう
朝寝坊			あさねぼう
混雑			こんざつ
何れ			どれ
相変わらず			あいかわらず
所持			しょじ
飛行			ひこう
供			きょう
結局			けっきょく
上			かみ
真面目			まじめ
反する			はんする
追う			おう
話し合う			はなしあう
経由			けいゆ
向ける			むける
居眠り			いねむり
文化財			ぶんかざい
落下			らっか
広がる			ひろがる
残酷			ざんこく
			じゃあ
奨学金			しょうがくきん
			あんまり
本体			ほんたい
空き			あき
広告			こうこく
資源			しげん
喉			のど
荒らす			あらす
書物			しょもつ
近視			きんし
分析			ぶんせき
好調			こうちょう
実現			じつげん
育つ			そだつ
嬉しい			うれしい
しまい			（終わり）
保つ			たもつ
真ん前			まんまえ
提出			ていしゅつ
刺繍			ししゅう
連日			れんじつ
提供			ていきょう
触れる			ふれる
婚約			こんやく
			あっさり
時折			ときおり
終日			しゅうじつ
冷やかす			ひやかす
			デート
束の間			つかのま
畜産			ちくさん
			テレックス
相			あい
			たっぷり
頻りに			しきりに
今日			こんにち
佳句			かく
参加			さんか
視点			してん
			クラシック
			まあ
日取り			ひどり
一人でに			ひとりでに
そう			そう
意向			いこう
愛憎			あいにく
全く			まったく
大半			たいはん
			ボール
未だ			まだ
			チーズ
生命			せいめい
			インフォメーション
嫋か			しなやか
手数			てかず
でも			でも
遣る			やる
ね			（感）
			トップ
仲			なか
騒動			そうどう
勝ち			かち
箇条書き			かじょうがき
解釈			かいしゃく
女優			じょゆう
人柄			ひとがら
音			ね
気まぐれ			きまぐれ
様子			ようす
処置			しょち
批評			ひひょう
			ちやほや
工場			こうば
割る			わる
巨大			きょだい
泥			どろ
明朗			めいろう
通す			とおす
腐る			くさる
株式			かぶしき
案			あん
婿			むこ
下がる			さがる
			いけない
学士			がくし
失調			しっちょう
荷造り			にづくり
			だって
魅力			みりょく
不順			ふじゅん
解く			とく
屋根			やね
凍る			こおる
計算			けいさん
何か			なにか
碌に			ろくに
剥ぐ			はぐ
著者			ちょしゃ
無			ぶ
届け			とどけ
理論			りろん
火曜			かよう
爆発			ばくはつ
事業			じぎょう
支配			しはい
否			いや
船舶			せんぱく
気軽			きがる
趣			おもむき
発表			はっぴょう
熱帯			ねったい
大幅			おおはば
放す			はなす
留める			とめる
幾ら			いくら
褒める			ほめる
悩み			なやみ
球			きゅう
妥結			だけつ
資金			しきん
平等			びょうどう
上位			じょうい
振る			ふる
老人			ろうじん
誂える			あつらえる
減る			へる
			カット
婦人			ふじん
綿			わた
強まる			つよまる
新鮮			しんせん
			タイミング
方			ほう
占める			しめる
			ベンチ
一種			いっしゅ
門			かど
捕鯨			ほげい
中指			ちゅうし
軍			ぐん
参上			さんじょう
仏			ほとけ
飛び出す			とびだす
毎			ごと
丸			まる
制定			せいてい
流す			ながす
粉			こな
議会			ぎかい
			アルミ
像			ぞう
			マーケット
次第			しだい
拐う			さらう
			ゆとり
礼			れい
休憩			きゅうけい
明後日			みょうごにち
桜			さくら
用法			ようほう
黄金			おうごん
離れる			はなれる
毒			どく
消費			しょうひ
			たびたび
諦める			あきらめる
女王			じょおう
屡			しばしば
有機			ゆうき
警告			けいこく
			もしも
梅雨			つゆ
			マスコミ
義務			ぎむ
年月			としつき
背			せい
引用			いんよう
地球			ちきゅう
辻褄			つじつま
萎む			しぼむ
故障			こしょう
志す			こころざす
入口			いりくち
腐る			くさる
世代			せだい
			レンタカー
織物			おりもの
信号			しんごう
費用			ひよう
日夜			にちや
紛失			ふんしつ
毟る			むしる
中心			ちゅうしん
免許			めんきょ
懲りる			こりる
胸			むね
成る丈			なるたけ
体験			たいけん
民主			みんしゅ
一同			いちどう
			おそらく
金持ち			かねもち
火災			かさい
欠陥			けっかん
袖			そで
馬鹿			ばか
本当			ほんと
党			とう
入学			にゅうがく
零れる			こぼれる
委員			いいん
原油			げんゆ
ヶ月			かげつ
励ます			はげます
浸す			ひたす
うまい			うまい
極楽			ごくらく
戦う			たたかう
達者			たっしゃ
徹する			てっする
軍隊			ぐんたい
広がる			ひろがる
先ず			まず
殿様			とのさま
動機			どうき
倒す			たおす
発病			はつびょう
構想			こうそう
一人一人			ひとりひとり
完全			かんぜん
動的			どうてき
原文			げんぶん
答案			とうあん
馴らす			ならす
無闇に			むやみに
階層			かいそう
発足			はっそく
砂漠			さばく
花壇			かだん
火星			かせい
地方			ちほう
為る			する
空			から
そこ			そこ
履く			はく
			すなわち
			インターナショナル
従兄弟			いとこ
地			ち
大筋			おおすじ
機関			きかん
見合わせる			みあわせる
製品			せいひん
七			しち
掴む			つかむ
決行			けっこう
患者			かんじゃ
抵抗			ていこう
その			その
			デザイン
輪			わ
走行			そうこう
疑問			ぎもん
末			うら
通過			つうか
漁船			ぎょせん
保養			ほよう
前もって			まえもって
負け			まけ
跨がる			またがる
			あっ
埋蔵			まいぞう
事件			じけん
偏見			へんけん
食料			しょくりょう
手引き			てびき
酔う			よう
設計			せっけい
桟橋			さんきょう
			チーム
希望			きぼう
決まる			きまる
角			すみ
拒否			きょひ
原			はら
打ち合わせ			うちあわせ
半ば			なかば
			しばしば
先先月			せんせんげつ
			ソファー
宗教			しゅうきょう
真っ赤			まっか
起点			きてん
一向			ひたすら
信用			しんよう
際			さい
心得			こころえ
沈没			ちんぼつ
県			けん
規定			きてい
詩人			しじん
上昇			じょうしょう
平和			へいわ
辛い			つらい
分業			ぶんぎょう
釣り			つり
印			いん
夫人			ふじん
名簿			めいぼ
実験			じっけん
切れる			きれる
大水			おおみず
文字			もじ
			オートマチック
短大			たんだい
成熟			せいじゅく
違える			ちがえる
葬る			ほうむる
記憶			きおく
造る			つくる
順番			じゅんばん
機械			きかい
割り当て			わりあて
			ふんだん
単純			たんじゅん
ご馳走			ごちそう
地方			じかた
差別			さべつ
中程			なかほど
林業			りんぎょう
遣い			つかい
面			めん
			ウェートレス
改訂			かいてい
永久			えいきゅう
彼等			かれら
番			ばん
輝く			かがやく
反発			はんぱつ
無視			むし
不審			ふしん
程度			ていど
交換			こうかん
噴出			ふんしゅつ
否決			ひけつ
			いい
遮る			さえぎる
食糧			しょくりょう
強硬			きょうこう
人民			じんみん
積極的			せっきょくてき
災害			さいがい
詐欺			さぎ
調べ			しらべ
笑顔			えがお
膜			まく
気温			きおん
何で			なんで
備わる			そなわる
締め切り			しめきり
幸せ			しあわせ
発明			はつめい
雇用			こよう
電子			でんし
			サービス
			ありがとう
沖			おき
お先に			おさきに
広まる			ひろまる
長大			ちょうだい
笑い			わらい
噂			うわさ
硬い			かたい
薄弱			はくじゃく
監視			かんし
一方			いっぽう
実は			じつは
蓮			はす
			うなる
国語			こくご
丸々			まるまる
署名			しょめい
指す			さす
捗る			はかどる
型			かた
柄			え
揶揄う			からかう
数			かず
破棄			はき
偶然			ぐうぜん
終			おわり
説			せつ
衝撃			しょうげき
退ける			しりぞける
差			さ
合わせ			あわせ
教師			きょうし
空ろ			うつろ
要因			よういん
承諾			しょうだく
準ずる			じゅんずる
			チャンネル
詰まり			つまり
芽			め
舗装			ほそう
操作			そうさ
都			みやこ
試みる			こころみる
式場			しきじょう
設置			せっち
優越			ゆうえつ
磁気			じき
唯			たった
過去			かこ
言わば			いわば
洒落			しゃらく
手伝い			てつだい
者			もの
夫婦			ふうふ
主張			しゅちょう
衆議院			しゅうぎいん
幹部			かんぶ
再び			ふたたび
丸い			まるい
或			ある
			クリーム
兵士			へいし
明ける			あける
お昼			おひる
貝殻			かいがら
球根			きゅうこん
			ヨット
叱る			しかる
掃除			そうじ
犯す			おかす
茶			ちゃ
未来			みらい
可成			かなり
登校			とうこう
降ろす			おろす
犯人			はんにん
身なり			みなり
			テント
仕入れる			しいれる
本物			ほんもの
			うなる
水源			すいげん
検査			けんさ
去る			さる
決まり悪い			きまりわるい
面会			めんかい
他人			あだびと
金額			きんがく
止める			とどめる
駄作			ださく
塀			へい
購入			こうにゅう
濫用			らんよう
恋			こい
			がっかり
貯金			ちょきん
集団			しゅうだん
安定			あんてい
鳥居			とりい
議論			ぎろん
核			かく
達する			たっする
段			だん
以前			いぜん
九			きゅう
打付ける			ぶつける
熱心			ねっしん
			かわいそう
抜かす			ぬかす
並み			なみ
			パスポート
大いに			おおいに
疑問			ぎもん
成功			せいこう
芝生			しばふ
消去			しょうきょ
一時			いちじ
詩			し
眺め			ながめ
一体			いったい
拝借			はいしゃく
よろしく			（感）
待ち合わせ			まちあわせ
権利			けんり
弁解			べんかい
総会			そうかい
観察			かんさつ
			ひょっと
空しい			むなしい
希望			きぼう
条約			じょうやく
英雄			えいゆう
心情			しんじょう
預金			よきん
得る			える
流			りゅう
感じる			かんじる
毒			どく
			ユーモア
受け止める			うけとめる
引き上げる			ひきあげる
曜日			ようび
着工			ちゃっこう
税金			ぜいきん
賭ける			かける
許可			きょか
不図			ふと
贅沢			ぜいたく
略語			りゃくご
			ぴったり
素敵			すてき
現金			げんきん
夢中			むちゅう
華々しい			はなばなしい
第			だい
湿気る			しける
情勢			じょうせい
執着			しゅうじゃく
尊ぶ			たっとぶ
			ダイヤ
怪我			けが
阻止			そし
豪華			ごうか
			ずっと
腸			ちょう
一心			いっしん
小屋			こや
素材			そざい
			ナイター
お祖父さん			おじいさん
利口			りこう
沿い			ぞい
程			ほど
監督			かんとく
心掛け			こころがけ
現行			げんこう
好い			よい
憂鬱			ゆううつ
粥			かゆ
貯金			ちょきん
断言			だんげん
見落とす			みおとす
暖かい			あたたか(い)
生			せい
障害			しょうがい
手間			てま
心中			しんじゅう
土			つち
果てる			はてる
金属			きんぞく
発展			はってん
外出			がいしゅつ
幾多			いくた
常に			つねに
除く			のぞく
気触れる			かぶれる
掲載			けいさい
手本			てほん
途上			とじょう
有難う			ありがとう
覚え			おぼえ
			かなり
対象			たいしょう
尻			しり
彼等			かれら
愛する			あいする
粘り			ねばり
贋物			がんぶつ
良質			りょうしつ
助け			たすけ
数			すう
見舞い			みまい
共感			きょうかん
復旧			ふくきゅう
適性			てきせい
吝嗇			けち
値段			ねだん
取り次ぐ			とりつぐ
封鎖			ふうさ
			スチーム
			ミルク
笑顔			えがお
			どうか
来			らい
判断			はんだん
合図			あいず
食う			くう
左様なら			さようなら
人目			じんもく
複合			ふくごう
戦い			たたかい
劇			げき
所為			せい
派遣			はけん
安っぽい			やすっぽい
出会う			であう
著しい			いちじるしい
かも知れない			かもしれない
年代			ねんだい
名産			めいさん
解釈			かいしゃく
済みません			すみません
それ			（接。感）
使命			しめい
尽くす			つくす
係り			かかり
夜			よ
中古			ちゅうこ
用心			ようじん
鍛える			きたえる
同志			どうし
区別			くべつ
部門			ぶもん
引き取る			ひきとる
			ランプ
不山戯る			ふざける
貴い			たっとい
覚める			さめる
便り			たより
勝利			しょうり
運搬			うんぱん
籤引			くじびき
劣る			おとる
			ウイスキー
			ドレス
すみません			（感）
無し			なし
雑談			ざつだん
自在			じざい
引きずる			ひきずる
無能			むのう
議会			ぎかい
陰			かげ
鉄道			てつどう
弁論			べんろん
偉大			いだい
此の			この
県			けん
他			ほか
解決			かいけつ
灰皿			はいさら
幸い			さいわい
誘う			さそう
参照			さんしょう
			ぶらぶら
			いやに
			コンパス
獲物			えもの
満ちる			みちる
噛る			かじる
養う			やしなう
穀物			こくもつ
列車			れっしゃ
非常			ひじょう
貧乏			びんぼう
群			ぐん
経由			けいゆ
対談			たいだん
			ぞんざい
粗筋			あらすじ
賞			しょう
示す			しめす
確実			かくじつ
急速			きゅうそく
戦う			たたかう
把握			はあく
徹底			てってい
審査			しんさ
ご無沙汰			ごぶさた
引き下げる			ひきさげる
刈る			かる
級			きゅう
育ち			そだち
お宮			おみや
掲示			けいじ
年号			ねんごう
旧			きゅう
			チャンス
			くっきり
尤も			もっとも
議事堂			ぎじどう
熱帯			ねったい
去る			さる
芽			め
虎			とら
取りあえず			とりあえず
			ファン
画期			かっき
曜日			ようび
書評			しょひょう
判決			はんけつ
金槌			かなづち
旅			たび
納得			なっとく
管			くだ
合わす			あわす
			ちょうだい
害			がい
課			か
場			ば
宜しく			よろしく
来			らい
			なにも
追い付く			おいつく
財			ざい
			きっちり
			ワット
従事			じゅうじ
揺さぶる			ゆさぶる
			おしゃべり
死亡			しぼう
一寸			ちょっと
鬱陶しい			うっとうしい
優			やさ
避難			ひなん
決心			けっしん
強請る			ねだる
彼方此方			あちこち
卑しい			いやしい
模様			もよう
うまい			うまい
優秀			ゆうしゅう
小包			こづつみ
利口			りこう
下さる			くださる
金庫			かねぐら
定年			ていねん
国会			こっかい
今後			こんご
取り扱う			とりあつかう
問う			とう
			コード
他人			たにん
			タイムリー
学説			がくせつ
横綱			よこづな
女子			じょし
居眠り			いねむり
痛み			いたみ
			ホーム
お喋り			おしゃべり
多少			たしょう
破る			やぶる
否			いや
効率			こうりつ
農耕			のうこう
防ぐ			ふせぐ
			イエス
保育			ほいく
掛かる			かかる
筋肉			きんにく
済ませる			すませる
休学			きゅうがく
候補			こうほ
出題			しゅつだい
袋			ふくろ
沸騰			ふっとう
			オーケー
今に			いまに
			シック
			ずらっと
芝居			しばい
組合			くみあい
再生			さいせい
汚染			おせん
全国			ぜんこく
思い出			おもいで
整列			せいれつ
恐ろしい			おそろしい
減らす			へらす
芝			しば
住宅			じゅうたく
大部分			だいぶぶん
軌道			きどう
沈める			しずめる
現象			げんしょう
命じる			めいじる
予期			よき
			スイッチ
			オフィス
会員			かいいん
計			けい
合計			ごうけい
打ち切る			うちきる
			カンニング
作家			さっか
			インク
原っぱ			はらっぱ
請求			せいきゅう
氾濫			はんらん
雛			ひな
拍手			はくしゅ
発明			はつめい
跨ぐ			またぐ
故人			こじん
共鳴			きょうめい
			プラン
適する			てきする
共同			きょうどう
			タワー
大変			たいへん
濠			ほり
更に			さらに
日本			にほん
包み			つつみ
			いらっしゃい
委託			いたく
目方			めかた
容易			ようい
崩壊			ほうかい
水洗			すいせん
推薦			すいせん
刺激			しげき
御免ください			ごめんください
資源			しげん
不利			ふり
手順			てじゅん
誰か			だれか
少年			しょうねん
知能			ちのう
			かもしれない
進歩			しんぽ
罹る			かかる
妊娠			にんしん
丈			たけ
邪魔			じゃま
警戒			けいかい
馬鹿馬鹿しい			ばかばかしい
招待			しょうたい
整える			ととのえる
刈る			かる
露			つゆ
作品			さくひん
形成			けいせい
色彩			しきさい
分裂			ぶんれつ
一番			いちばん
弄る			いじる
含む			ふくむ
係			かかり
待遇			たいぐう
汗			あせ
重大			じゅうだい
発掘			はっくつ
否			いいえ
旅券			りょけん
色々			いろいろ
			レンジ
美			び
一律			いちりつ
深刻			しんこく
			パーセント
			ヤング
少しも			すこしも
不可欠			ふかけつ
			これら
財源			ざいげん
万能			ばんのう
身長			しんちょう
申し訳			もうしわけ
投げ出す			なげだす
姉妹			きょうだい
身体			しんたい
濡れる			ぬれる
			モーテル
実に			じつに
賜る			たまわる
捧げる			ささげる
婉曲			えんきょく
挨拶			あいさつ
起こる			おこる
			タイル
話し合い			はなしあい
下調べ			したしらべ
名人			めいじん
大金			たいきん
着色			ちゃくしょく
還暦			かんれき
暮れ			くれ
同様			どうよう
視覚			しかく
様			よう
係			かかり
指示			しじ
等			など
賭け			かけ
脚本			きゃくほん
切り替える			きりかえる
小柄			こがら
話し合う			はなしあう
指摘			してき
具体			ぐたい
蒸留			じょうりゅう
遅くとも			おそくとも
代表			だいひょう
お互い			おたがい
連想			れんそう
粗			あら
城			しろ
継ぎ目			つぎめ
空く			すく
黒字			くろじ
昼食			ちゅうしょく
密集			みっしゅう
移す			うつす
額			がく
暮らし			くらし
握手			あくしゅ
賞			しょう
何気ない			なにげない
歯科			しか
耳鼻科			じびか
			エレガント
			アイロン
非			ひ
殊に			ことに
盲点			もうてん
認める			したためる
均衡			きんこう
改革			かいかく
日付			ひづけ
叱る			しかる
地区			ちく
産休			さんきゅう
大会			たいかい
保証			ほしょう
頃			けい
着手			ちゃくしゅ
波			なみ
学			がく
逆上る			さかのぼる
			パイロット
証			あかし
関心			かんしん
偏る			かたよる
唱える			となえる
栄養			えいよう
自転			じてん
見送り			みおくり
垢			あか
氏			し
			コーナー
			いっそ
			チャンス
浪費			ろうひ
対辺			たいへん
予言			かねごと
見方			みかた
議員			ぎいん
週			しゅう
扱う			あつかう
			プラス
夕焼け			ゆうやけ
承知			しょうち
度々			たびたび
朽ちる			くちる
単調			たんちょう
主権			しゅけん
情熱			じょうねつ
辺り			ほとり
不便			ふびん
墜落			ついらく
中学			ちゅうがく
反応			はんのう
模型			もけい
暴風			ぼうふう
増加			ぞうか
周囲			しゅうい
問			もん
技			わざ
通行			つうこう
浴室			よくしつ
一連			いちれん
囀る			さえずる
計る			はかる
奉仕			ほうし
内			うち
宣教			せんきょう
			ナンセンス
偖			さて
途絶える			とだえる
			そのうち
注ぐ			つぐ
感心			かんしん
悉く			ことごとく
損			そん
音			おん
居間			いま
石炭			せきたん
慣用			かんよう
社交			しゃこう
人物			じんぶつ
職			しょく
独り			ひとり
拡散			かくさん
乏しい			とぼしい
孤立			こりつ
向ける			むける
声明			せいめい
			ドライブ
本音			ほんね
可能			かのう
全然			ぜんぜん
一生			いっしょう
抑圧			よくあつ
詰る			なじる
泌み泌み			しみじみ
終わる			おわる
追放			ついほう
			ベルト
活気			かっき
目標			もくひょう
記述			きじゅつ
相続			そうぞく
肥料			ひりょう
指令			しれい
商			しょう
各種			かくしゅ
尾			お
河			かわ
嘸			さぞ
分野			ぶんや
明ける			あける
使用			しよう
鉄道			てつどう
			アルバム
州			しゅう
手術			しゅじゅつ
失格			しっかく
形態			けいたい
取れる			とれる
加わる			くわわる
結び付ける			むすびつける
無線			むせん
増加			ぞうか
文字			もんじ
閉口			へいこう
補助			ほじょ
領地			りょうち
観客			かんきゃく
増進			ぞうしん
落ちる			おちる
兎に角			とにかく
我々			われわれ
			インターチェンジ
恋人			こいびと
信者			しんじゃ
過密			かみつ
清潔			せいけつ
定める			さだめる
先ず			まず
得点			とくてん
共に			ともに
			きちっと
			より
鮮やか			あざやか
			ミス
すれ違う			すれちがう
続き			つづき
鎖			くさり
合成			ごうせい
介入			かいにゅう
松			まつ
値			ね
			スケート
損害			そんがい
入学			にゅうがく
元首			げんしゅ
責務			せきむ
聴講			ちょうこう
慎重			しんちょう
長期			ちょうき
費			ひ
			だけど
悪			あく
角			すみ
吊り革			つりかわ
影			かげ
			ボイコット
正に			まさに
出会い			であい
一層			いっそう
離れる			はなれる
自動			じどう
認める			みとめる
単語			たんご
硬貨			こうか
			サンタクロース
得る			うる
躾			しつけ
挨拶			あいさつ
農民			のうみん
静止			せいし
			ちょくちょく
配達			はいたつ
笛			ふえ
豊富			ほうふ
演じる			えんじる
信仰			しんこう
見掛ける			みかける
			ワイン
民俗			みんぞく
傷			きず
製品			せいひん
実費			じっぴ
相応			そうおう
度忘れ			どわすれ
捜索			そうさく
布告			ふこく
講演			こうえん
騒音			そうおん
率いる			ひきいる
間違う			まちがう
還元			かんげん
生かす			いかす
呉れる			くれる
暮らす			くらす
身近			みぢか
齎らす			もたらす
放射			ほうしゃ
通学			つうがく
必ずしも			かならずしも
組む			くむ
挑戦			ちょうせん
散歩			さんぽ
硬貨			こうか
意欲			いよく
視野			しや
何故			なぜ
祝い			いわい
制度			せいど
			ハンサム
			キャリア
侵す			おかす
望ましい			のぞましい
鉱業			こうぎょう
			コンピューター
雷			かみなり
			しまった
裸足			はだし
放棄			ほうき
逃す			のがす
勉強			べんきょう
王			おう
延期			えんき
前者			ぜんしゃ
商人			あきうど
			ほっと
見送り			みおくり
呆然			ぼうぜん
育成			いくせい
正式			せいしき
地			ち
読み			よみ
戦術			せんじゅつ
			ばったり
覚める			さめる
正午			しょうご
			トラブル
表面			ひょうめん
樹木			じゅもく
常識			じょうしき
			パンク
現れる			あらわれる
弾力			だんりょく
逆			ぎゃく
賛美			さんび
うん			（感）
食欲			しょくよく
学者			がくしゃ
この			この
対等			たいとう
			おや
定期			ていき
期日			きじつ
試し			ためし
独身			どくしん
結ぶ			むすぶ
命じる			めいじる
代金			だいきん
一別			いちべつ
活動			かつどう
果たす			はたす
			ロマンチック
其処で			そこで
進化			しんか
活用			かつよう
頬			ほほ
丁々			とうとう
野党			やとう
背後			はいご
陽気			ようき
			わざと
商人			しょうにん
辺り			あたり
四			し
灰			はい
命令			めいれい
			ミュージック
並びに			ならびに
選択			せんたく
今に			いまに
箇箇			ここ
統率			とうそつ
			ところが
親しむ			したしむ
情報			じょうほう
詩			し
自動詞			じどうし
勧告			かんこく
腹立ち			はらだち
抗議			こうぎ
名残			なごり
玄人			くろうと
私用			しよう
人材			じんざい
橋渡し			はしわたし
鈍る			なまる
枚			まい
届く			とどく
酸素			さんそ
人間			にんげん
営む			いとなむ
合併			がっぺい
尤も			もっとも
美人			びじん
患者			かんじゃ
鍋			なべ
			ユニフォーム
だが			だが
昼食			ちゅうしょく
鋏			はさみ
徐々に			じょじょに
成果			せいか
			できれば
奨学金			しょうがくきん
持て成す			もてなす
別に			べつに
書類			しょるい
脱する			だっする
元			もと
取り引き			とりひき
中立			ちゅうりつ
適する			てきする
			およそ
革			かわ
帳			とばり
救済			きゅうさい
回す			まわす
注ぐ			そそぐ
震える			ふるえる
漕ぐ			こぐ
航空			こうくう
跡継ぎ			あとつぎ
			ほぼ
除外			じょがい
年輪			ねんりん
褒美			ほうび
混む			こむ
			だって
やり遂げる			やりとげる
再び			ふたたび
製造			せいぞう
駆けっこ			かけっこ
単独			たんどく
金融			きんゆう
提案			ていあん
			あいにく
饂飩			うどん
綿			めん
行き			いき
修飾			しゅうしょく
年中			ねんじゅう
			スタンド
守る			まもる
請求			せいきゅう
裏切る			うらぎる
放出			ほうしゅつ
現場			げんば
			やや
賢い			かしこい
内閣			ないかく
共に			ともに
肌			はだ
原			はら
			まあ
揉める			もめる
合格			ごうかく
察する			さっする
許容			きょよう
妨害			ぼうがい
処罰			しょばつ
			びっくり
			インターフォン
同感			どうかん
混雑			こんざつ
汚れ			けがれ
状況			じょうきょう
場面			ばめん
遠ざかる			とおざかる
何とも			なんとも
独創			どくそう
意識			いしき
発展			はってん
誘導			ゆうどう
捕まる			つかまる
操縦			そうじゅう
賛成			さんせい
時差			じさ
埃			ほこり
準備			じゅんび
女王			じょおう
高価			こうか
潜る			くぐる
先先週			せんせんしゅう
確認			かくにん
頻繁			ひんぱん
誕生			たんじょう
できる			（可能。出現。発生）
申し込む			もうしこむ
無			む
			ミス
縄			なわ
樹立			じゅりつ
それ			（接。感）
繰り返す			くりかえす
主題			しゅだい
其れ故			それゆえ
任す			まかす
利潤			りじゅん
乗客			じょうかく
真ん中			まんなか
詳細			しょうさい
滞在			たいざい
結論			けつろん
範囲			はんい
削減			さくげん
			いらっしゃい
労働			ろうどう
看護			かんご
苦しむ			くるしむ
何方			どなた
検討			けんとう
敬意			けいい
額			ひたい
立法			りっぽう
婦人			ふじん
通り過ぎる			とおりすぎる
横断			おうだん
肉親			にくしん
			コンピューター
頭痛			ずつう
誰			たれ
欠席			けっせき
天地			あめつち
起こる			おこる
用いる			もちいる
日向			ひなた
			ノイローゼ
菓子			かし
警部			けいぶ
空間			あきま
百科辞典			ひゃっかじてん
火花			ひばな
自慢			じまん
傷			しょう
狂う			くるう
携帯			けいたい
			おじいさん
快い			こころよい
			トランプ
運転			うんてん
周囲			しゅうい
蕩ける			とろける
爽やか			さわやか
善			ぜん
悲観			ひかん
観客			かんきゃく
緩和			かんわ
気象			きしょう
生			なま
甥			おい
専用			せんよう
多少			たしょう
接続詞			せつぞくし
局限			きょくげん
暴力			ぼうりょく
河			かわ
予算			よさん
新入生			しんにゅうせい
格差			かくさ
無用			むよう
絶つ			たつ
			ちょうだい
左利き			ひだりきき
不正			ふせい
幸運			こううん
			かもしれない
通じる			つうじる
何処			どこ
描く			えがく
分			ぶ
学ぶ			まなぶ
左程			さほど
独り			ひとり
文			ぶん
三日月			みかずき
やっ付ける			やっつける
転落			てんらく
単位			たんい
報告			ほうこく
見合い			みあい
凍る			こおる
備える			そなえる
若しかしたら			もしかしたら
外			ほか
生理			せいり
連続			れんぞく
市			いち
組み合わせる			くみあわせる
格好			かっこう
鎖			くさり
配列			はいれつ
活気			かっき
迷子			まいご
			かなり
痺れる			しびれる
共和			きょうわ
犯罪			はんざい
孫			まご
付け加える			つけくわえる
鍵			かぎ
人質			ひとじち
清濁			せいだく
募金			ぼきん
全体			ぜんたい
調査			ちょうさ
承認			しょうにん
意識			いしき
又			また
弁当			べんとう
級			きゅう
			しかも
有効			ゆうこう
怒り			いかり
企業			きぎょう
品			しな
仲間			なかま
鉛			なまり
			ボート
資本			しほん
転ぶ			ころぶ
固有			こゆう
図る			はかる
国境			こっきょう
各々			それぞれ
該当			がいとう
			まるで
発条			ばね
騒ぎ			さわぎ
吐く			つく
世の中			よのなか
万一			まんいち
離婚			りこん
織る			おる
芸術			げいじゅつ
			フェリー
率			りつ
試み			こころみ
世			よ
打開			だかい
家具			かぐ
実現			じつげん
作物			さくもつ
変化			へんか
国定			こくてい
弱まる			よわまる
結ぶ			むすぶ
願書			がんしょ
従う			したがう
大使			たいし
部分			ぶぶん
喉			のど
至って			いたって
陰気			いんき
墓地			はかち
公用			こうよう
			たっぷり
明かり			あかり
作家			さっか
伸ばす			のばす
系			けい
発表			はっぴょう
鉄			てつ
屎尿			しにょう
特許			とっきょ
候補			こうほ
確立			かくりつ
堪らない			たまらない
常に			つねに
共同			きょうどう
比率			ひりつ
独特			どくとく
乱れる			みだれる
停滞			ていたい
本当			ほんと
			ピン
称する			しょうする
			エンジニア
孤独			こどく
			けち
進行			しんこう
			ミスプリント
兼業			けんぎょう
			すてき
表			ひょう
荷			に
腕前			うでまえ
上			かみ
不平			ふへい
事件			じけん
性格			せいかく
賢い			かしこい
徐々			そろそろ
現地			げんち
			タオル
恐れ			おそれ
非常			ひじょう
好む			このむ
熱中			ねっちゅう
			なお
採算			さいさん
義理			ぎり
堪える			こたえる
幸福			こうふく
控除			こうじょ
苛める			いじめる
信号			しんごう
お世辞			おせじ
対する			たいする
命			いのち
怒る			いかる
臭い			くさい
主義			しゅぎ
弟			おと
			グラス
			バッジ
前例			ぜんれい
一部分			いちぶぶん
中心			ちゅうしん
宮殿			きゅうでん
塔			とう
梅			うめ
日の丸			ひのまる
霧			きり
取り上げる			とりあげる
宿			やど
照り返す			てりかえす
学期			がっき
黄色			おうしょく
目的			もくてき
			ベンチ
戯曲			ぎきょく
真っ直ぐ			まっすぐ
積もる			つもる
五月蝿い			うるさい
疑う			うたがう
支払			しはらい
要する			ようする
劇			げき
便宜			べんぎ
違いない			ちがいない
神秘			しんぴ
商品			しょうひん
家事			かじ
お目に掛かる			おめにかかる
成る			なる
行			ぎょう
命			いのち
灰			はい
宿			やど
労る			いたわる
権利			けんり
紛れる			まぎれる
基づく			もとづく
重視			じゅうし
敵			かたき
滲む			にじむ
歩み			あゆみ
濠			ほり
大部			たいぶ
未開			みかい
疲れ			つかれ
破裂			はれつ
抜く			ぬく
左右			さゆう
廃止			はいし
窮屈			きゅうくつ
後			うしろ
介抱			かいほう
知性			ちせい
着目			ちゃくもく
得意			とくい
上			じょう
日本			にっぽん
金庫			きんこ
夜行			やぎょう
技師			ぎし
贈る			おくる
配布			はいふ
優勝			ゆうしょう
慣れ			なれ
お洒落			おしゃれ
障る			さわる
			だけど
粋			いき
既に			すでに
同情			どうじょう
宿命			しゅくめい
川			かわ
断る			ことわる
			ベルト
付ける			つける
成績			せいせき
辟易			へきえき
岩			いわ
兆し			きざし
確信			かくしん
徒歩			とほ
最低			さいてい
溺れる			おぼれる
転ぶ			ころぶ
			それとも
聴診器			ちょうしんき
			クリーム
			いわゆる
国民			こくみん
承認			しょうにん
捲る			まくる
			ずっと
谷			たに
			どこか
兼ねて			かねて
回復			かいふく
重んずる			おもんずる
泡			あわ
その為			そのため
相手			あいて
危機			きき
			それぞれ
背く			そむく
幸福			こうふく
轢く			ひく
強盗			ごうとう
行儀			ぎょうぎ
負かす			まかす
気味			きみ
案			あん
章			しょう
据える			すえる
元素			げんそ
浮かぶ			うかぶ
粉々			こなごな
扉			とびら
七			しち
四			よん
帯びる			おびる
跡			あと
者			もの
加減			かげん
鈍感			どんかん
決心			けっしん
当たり			あたり
			あやふや
市場			いちば
			うるさい
枠			わく
減らす			へらす
乗り換え			のりかえ
女史			じょし
夜明け			よあけ
不動産			ふどうさん
著者			ちょしゃ
出動			しゅつどう
進歩			しんぽ
先行			せんこう
産む			うむ
原			げん
革命			かくめい
濡れる			ぬれる
是非			ぜひ
未定			みてい
留める			とどめる
皆			みんな
覆面			ふくめん
野			の
記名			きめい
代用			だいよう
信頼			しんらい
覚ます			さます
通りかかる			とおりかかる
先着			せんちゃく
凭れる			もたれる
選択			せんたく
政府			せいふ
譲歩			じょうほ
			ダース
簡易			かんい
			ぼんやり
瓶			びん
生育			せいいく
方法			ほうほう
依			い
迎え			むかえ
研ぐ			とぐ
痛感			つうかん
辞める			やめる
画家			がか
窒息			ちっそく
唯			ただ
乾			かん
順			じゅん
悲しむ			かなしむ
我慢			がまん
人間			にんげん
損なう			そこなう
大会			たいかい
柱			はしら
母親			ははおや
一人一人			ひとりひとり
季刊			きかん
実質			じっしつ
裁判			さいばん
			ピクニック
市街			しがい
箪笥			たんす
			ムード
細工			さいく
尊い			たっとい
心配			しんぱい
眉			まゆ
			ずばり
干し物			ほしもの
凡ゆる			あらゆる
鉄			てつ
而も			しかも
			キャンプ
既に			すでに
針			はり
お八			おやつ
			アルカリ
招待			しょうたい
股			また
気の毒			きのどく
球			きゅう
粉			こな
